A - AGILENT TECHNOLOGIES INC
AA - ALCOA CORP
AAC - ARES ACQUISITION CORP-A
AACI - ARMADA ACQUISITION CORP I
AADI - AADI BIOSCIENCE INC
AAL - AMERICAN AIRLINES GROUP INC
AAME - ATLANTIC AMERICAN CORP
AAN - AARON'S CO INC/THE
AAOI - APPLIED OPTOELECTRONICS INC
AAON - AAON INC
AAP - ADVANCE AUTO PARTS INC
AAPL - APPLE INC
AAQC - ACCELERATE ACQUISITION COR-A
AATC - AUTOSCOPE TECHNOLOGIES CORP
AAWW - ATLAS AIR WORLDWIDE HOLDINGS
ABBV - ABBVIE INC
ABC - AMERISOURCEBERGEN CORP
ABCB - AMERIS BANCORP
ABCL - ABCELLERA BIOLOGICS INC
ABEO - ABEONA THERAPEUTICS INC
ABG - ASBURY AUTOMOTIVE GROUP
ABGI - ABG ACQUISITION CORP I - A
ABIO - ARCA BIOPHARMA INC
ABM - ABM INDUSTRIES INC
ABMD - ABIOMED INC
ABNB - AIRBNB INC-CLASS A
ABOS - ACUMEN PHARMACEUTICALS INC
ABSI - ABSCI CORP
ABST - ABSOLUTE SOFTWARE CORPORATIO
ABT - ABBOTT LABORATORIES
ABTX - ALLEGIANCE BANCSHARES INC
ABUS - ARBUTUS BIOPHARMA CORP
ABVC - ABVC BIOPHARMA INC
AC - ASSOCIATED CAPITAL GROUP - A
ACA - ARCOSA INC
ACAD - ACADIA PHARMACEUTICALS INC
ACAH - ATLANTIC COASTAL ACQUISITI-A
ACAQ - ATHENA CONSUMER ACQUISITIO-A
ACB - AURORA CANNABIS INC
ACBA - ACE GLOBAL BUSINESS ACQUISIT
ACBI - ATLANTIC CAPITAL BANCSHARES
ACCD - ACCOLADE INC
ACCO - ACCO BRANDS CORP
ACEL - ACCEL ENTERTAINMENT INC
ACER - ACER THERAPEUTICS INC
ACET - ADICET BIO INC
ACEV - ACE CONVERGENCE ACQU-CLASS A
ACGL - ARCH CAPITAL GROUP LTD
ACHC - ACADIA HEALTHCARE CO INC
ACHR - ARCHER AVIATION INC-A
ACHV - ACHIEVE LIFE SCIENCES INC
ACI - ALBERTSONS COS INC - CLASS A
ACII - ATLAS CREST INVESTMENT COR-A
ACIU - AC IMMUNE SA
ACIW - ACI WORLDWIDE INC
ACLS - AXCELIS TECHNOLOGIES INC
ACM - AECOM
ACMR - ACM RESEARCH INC-CLASS A
ACN - ACCENTURE PLC-CL A
ACNB - ACNB CORP
ACOR - ACORDA THERAPEUTICS INC
ACQR - INDEPENDENCE HDS CORP-CL A
ACRO - ACROPOLIS INFRASTRUCTURE - A
ACRS - ACLARIS THERAPEUTICS INC
ACRX - ACELRX PHARMACEUTICALS INC
ACST - ACASTI PHARMA INC
ACT - ENACT HOLDINGS INC
ACTD - ARCLIGHT CLEAN TRANSITION -A
ACTG - ACACIA RESEARCH CORP
ACVA - ACV AUCTIONS INC-A
ACXP - ACURX PHARMACEUTICALS INC
ADBE - ADOBE INC
ADCT - ADC THERAPEUTICS SA
ADER - 26 CAPITAL ACQUISITION COR-A
ADES - ADVANCED EMISSIONS SOLUTIONS
ADEX - ADIT EDTECH ACQUISITION
ADGI - ADAGIO THERAPEUTICS INC
ADI - ANALOG DEVICES INC
ADIL - ADIAL PHARMACEUTICALS INC
ADM - ARCHER-DANIELS-MIDLAND CO
ADMA - ADMA BIOLOGICS INC
ADMP - ADAMIS PHARMACEUTICALS CORP
ADN - ADVENT TECHNOLOGIES HOLDINGS
ADNT - ADIENT PLC
ADOC - EDOC ACQUISITION CORP-CL A
ADP - AUTOMATIC DATA PROCESSING
ADPT - ADAPTIVE BIOTECHNOLOGIES
ADS - ALLIANCE DATA SYSTEMS CORP
ADSK - AUTODESK INC
ADT - ADT INC
ADTN - ADTRAN INC
ADTX - ADITXT INC
ADUS - ADDUS HOMECARE CORP
ADV - ADVANTAGE SOLUTIONS INC
ADVM - ADVERUM BIOTECHNOLOGIES INC
ADXS - ADVAXIS INC
AEAC - AUTHENTIC EQUITY ACQUISITI-A
AEAE - ALTENERGY ACQUISITION CORP-A
AEE - AMEREN CORPORATION
AEHA - AESTHER HEALTHCARE ACQU-CL A
AEHL - ANTELOPE ENTERPRISE HOLDINGS
AEHR - AEHR TEST SYSTEMS
AEI - ALSET EHOME INTERNATIONAL IN
AEIS - ADVANCED ENERGY INDUSTRIES
AEL - AMERICAN EQUITY INVT LIFE HL
AEM - AGNICO EAGLE MINES LTD
AEMD - AETHLON MEDICAL INC
AEO - AMERICAN EAGLE OUTFITTERS
AEP - AMERICAN ELECTRIC POWER
AER - AERCAP HOLDINGS NV
AERC - AEROCLEAN TECHNOLOGIES INC
AERI - AERIE PHARMACEUTICALS INC
AES - AES CORP
AESE - ALLIED ESPORTS ENTERTAINMENT
AEVA - AEVA TECHNOLOGIES INC
AEY - ADDVANTAGE TECHNOLOGIES GRP
AEYE - AUDIOEYE INC
AEZS - AETERNA ZENTARIS INC
AFAQ - AF ACQUISITION CORP-CLASS A
AFBI - AFFINITY BANCSHARES INC
AFG - AMERICAN FINANCIAL GROUP INC
AFI - ARMSTRONG FLOORING INC
AFIB - ACUTUS MEDICAL INC
AFL - AFLAC INC
AFMD - AFFIMED NV
AFRM - AFFIRM HOLDINGS INC
AFTR - AFTERNEXT HEALTHTECH ACQUI-A
AFYA - AFYA LTD-CLASS A
AG - FIRST MAJESTIC SILVER CORP
AGAC - AFRICAN GOLD ACQUISITION C-A
AGBA - AGBA ACQUISITION LTD
AGCB - ALTIMETER GROWTH CORP 2-A
AGCO - AGCO CORP
AGEN - AGENUS INC
AGFS - AGROFRESH SOLUTIONS INC
AGFY - AGRIFY CORP
AGGR - AGILE GROWTH CORP-A
AGI - ALAMOS GOLD INC-CLASS A
AGIL - AGILETHOUGHT INC
AGIO - AGIOS PHARMACEUTICALS INC
AGL - AGILON HEALTH INC
AGLE - AEGLEA BIOTHERAPEUTICS INC
AGM - FEDERAL AGRIC MTG CORP-CL C
AGM.A - FEDERAL AGRIC MTG CORP-CL A
AGMH - AGM GROUP HOLDINGS INC
AGO - ASSURED GUARANTY LTD
AGR - AVANGRID INC
AGRI - AGRIFORCE GROWING SYSTEMS LT
AGRO - ADECOAGRO SA
AGRX - AGILE THERAPEUTICS INC
AGS - PLAYAGS INC
AGTC - APPLIED GENETIC TECHNOLOGIES
AGTI - AGILITI INC
AGX - ARGAN INC
AGYS - AGILYSYS INC
AHCO - ADAPTHEALTH CORP
AHPA - AVISTA PUBLIC ACQUIS-CLASS A
AHPI - ALLIED HEALTHCARE PRODUCTS
AI - C3.AI INC-A
AIG - AMERICAN INTERNATIONAL GROUP
AIHS - SENMIAO TECHNOLOGY LTD
AIKI - AIKIDO PHARMA INC
AIMC - ALTRA INDUSTRIAL MOTION CORP
AIN - ALBANY INTL CORP-CL A
AINV - APOLLO INVESTMENT CORP
AIP - ARTERIS INC
AIR - AAR CORP
AIRG - AIRGAIN INC
AIRS - AIRSCULPT TECHNOLOGIES INC
AIRT - AIR T INC
AIT - APPLIED INDUSTRIAL TECH INC
AIZ - ASSURANT INC
AJG - ARTHUR J GALLAGHER & CO
AJRD - AEROJET ROCKETDYNE HOLDINGS
AKA - AKA BRANDS HOLDING CORP
AKAM - AKAMAI TECHNOLOGIES INC
AKBA - AKEBIA THERAPEUTICS INC
AKIC - SPORTS VENTURES ACQUISITIO-A
AKRO - AKERO THERAPEUTICS INC
AKTS - AKOUSTIS TECHNOLOGIES INC
AKU - AKUMIN INC
AKUS - AKOUOS INC
AKYA - AKOYA BIOSCIENCES INC
AL - AIR LEASE CORP
ALAC - ALBERTON ACQUISITION CORP
ALB - ALBEMARLE CORP
ALBO - ALBIREO PHARMA INC
ALC - ALCON INC
ALCC - ALTC ACQUISITION CORP-CL A
ALCO - ALICO INC
ALDX - ALDEYRA THERAPEUTICS INC
ALE - ALLETE INC
ALEC - ALECTOR INC
ALF - ALFI INC
ALG - ALAMO GROUP INC
ALGM - ALLEGRO MICROSYSTEMS INC
ALGN - ALIGN TECHNOLOGY INC
ALGS - ALIGOS THERAPEUTICS INC
ALGT - ALLEGIANT TRAVEL CO
ALHC - ALIGNMENT HEALTHCARE INC
ALIM - ALIMERA SCIENCES INC
ALIT - ALIGHT INC - CLASS A
ALJJ - ALJ REGIONAL HOLDINGS INC
ALK - ALASKA AIR GROUP INC
ALKS - ALKERMES PLC
ALKT - ALKAMI TECHNOLOGY INC
ALL - ALLSTATE CORP
ALLE - ALLEGION PLC
ALLK - ALLAKOS INC
ALLO - ALLOGENE THERAPEUTICS INC
ALLR - ALLARITY THERAPEUTICS INC
ALLT - ALLOT LTD
ALLY - ALLY FINANCIAL INC
ALNA - ALLENA PHARMACEUTICALS INC
ALNY - ALNYLAM PHARMACEUTICALS INC
ALOT - ASTRONOVA INC
ALPA - ALPHA HEALTHCARE ACQUISITI-A
ALPN - ALPINE IMMUNE SCIENCES INC
ALPP - ALPINE 4 HOLDINGS INC
ALRM - ALARM.COM HOLDINGS INC
ALRN - AILERON THERAPEUTICS INC
ALRS - ALERUS FINANCIAL CORP
ALSN - ALLISON TRANSMISSION HOLDING
ALT - ALTIMMUNE INC
ALTG - ALTA EQUIPMENT GROUP INC
ALTM - ALTUS MIDSTREAM CO -A
ALTO - ALTO INGREDIENTS INC
ALTR - ALTAIR ENGINEERING INC - A
ALTU - ALTITUDE ACQUISITION CORP-A
ALV - AUTOLIV INC
ALVR - ALLOVIR INC
ALXO - ALX ONCOLOGY HOLDINGS INC
ALYA - ALITHYA GROUP INC-CLASS A
ALZN - ALZAMEND NEURO INC
AM - ANTERO MIDSTREAM CORP
AMAL - AMALGAMATED FINANCIAL CORP
AMAO - AMERICAN ACQUISITION OP-CL A
AMAT - APPLIED MATERIALS INC
AMBA - AMBARELLA INC
AMBC - AMBAC FINANCIAL GROUP INC
AMBP - ARDAGH METAL PACKAGING SA
AMC - AMC ENTERTAINMENT HLDS-CL A
AMCI - AMCI ACQUISITION CORP II-A
AMCR - AMCOR PLC
AMCX - AMC NETWORKS INC-A
AMD - ADVANCED MICRO DEVICES
AME - AMETEK INC
AMED - AMEDISYS INC
AMEH - APOLLO MEDICAL HOLDINGS INC
AMG - AFFILIATED MANAGERS GROUP
AMGN - AMGEN INC
AMK - ASSETMARK FINANCIAL HOLDINGS
AMKR - AMKOR TECHNOLOGY INC
AMN - AMN HEALTHCARE SERVICES INC
AMNB - AMER NATL BNKSHS/DANVILLE VA
AMOT - ALLIED MOTION TECHNOLOGIES
AMP - AMERIPRISE FINANCIAL INC
AMPG - AMPLITECH GROUP INC
AMPH - AMPHASTAR PHARMACEUTICALS IN
AMPI - ADVANCED MERGER PARTNERS I-A
AMPL - AMPLITUDE INC-CLASS A
AMPS - ALTUS POWER INC
AMPY - AMPLIFY ENERGY CORP
AMR - ALPHA METALLURGICAL RESOURCE
AMRC - AMERESCO INC-CL A
AMRK - A-MARK PRECIOUS METALS INC
AMRS - AMYRIS INC
AMRX - AMNEAL PHARMACEUTICALS INC
AMSC - AMERICAN SUPERCONDUCTOR CORP
AMSF - AMERISAFE INC
AMST - AMESITE INC
AMSWA - AMERICAN SOFTWARE INC-CL A
AMTB - AMERANT BANCORP INC
AMTI - APPLIED MOLECULAR TRANSPORT
AMTX - AEMETIS INC
AMWD - AMERICAN WOODMARK CORP
AMWL - AMERICAN WELL CORP-CLASS A
AMZN - AMAZON.COM INC
AN - AUTONATION INC
ANAB - ANAPTYSBIO INC
ANAC - ARCTOS NORTHSTAR ACQUISIT-A
ANAT - AMERICAN NATIONAL GROUP INC
ANDE - ANDERSONS INC/THE
ANEB - ANEBULO PHARMACEUTICALS INC
ANET - ARISTA NETWORKS INC
ANF - ABERCROMBIE & FITCH CO-CL A
ANGI - ANGI INC
ANGN - ANGION BIOMEDICA CORP
ANGO - ANGIODYNAMICS INC
ANIK - ANIKA THERAPEUTICS INC
ANIP - ANI PHARMACEUTICALS INC
ANIX - ANIXA BIOSCIENCES INC
ANNX - ANNEXON INC
ANSS - ANSYS INC
ANTM - ANTHEM INC
ANVS - ANNOVIS BIO
ANY - SPHERE 3D CORP
ANZU - ANZU SPECIAL ACQUISITION -A
AON - AON PLC-CLASS A
AOS - SMITH (A.O.) CORP
AOSL - ALPHA & OMEGA SEMICONDUCTOR
AOUT - AMERICAN OUTDOOR BRANDS INC
AP - AMPCO-PITTSBURGH CORP
APA - APA CORP
APAC - STONEBRIDGE ACQUISITION CORP
APAM - ARTISAN PARTNERS ASSET MA -A
APD - AIR PRODUCTS & CHEMICALS INC
APDN - APPLIED DNA SCIENCES INC
APEI - AMERICAN PUBLIC EDUCATION
APEN - APOLLO ENDOSURGERY INC
APG - API GROUP CORP
APGB - APOLLO STRATEGIC GROWTH-CL A
APH - AMPHENOL CORP-CL A
APLS - APELLIS PHARMACEUTICALS INC
APLT - APPLIED THERAPEUTICS INC
APM - APTORUM GROUP LTD-CLASS A
APMI - AXONPRIME INFRASTRUCTURE-A
APO - APOLLO GLOBAL MANAGEMENT INC
APOG - APOGEE ENTERPRISES INC
APP - APPLOVIN CORP-CLASS A
APPF - APPFOLIO INC - A
APPH - APPHARVEST INC
APPN - APPIAN CORP
APPS - DIGITAL TURBINE INC
APR - APRIA INC
APRE - APREA THERAPEUTICS INC
APRN - BLUE APRON HOLDINGS INC-A
APSG - APOLLO STRATEGIC GROWTH-CL A
APTM - ALPHA PARTNERS TECHNOLOGY-A
APTO - APTOSE BIOSCIENCES INC
APTV - APTIV PLC
APTX - APTINYX INC
APVO - APTEVO THERAPEUTICS INC
APWC - ASIA PACIFIC WIRE & CABLE
APYX - APYX MEDICAL CORP
AQB - AQUABOUNTY TECHNOLOGIES
AQMS - AQUA METALS INC
AQN - ALGONQUIN POWER & UTILITIES
AQST - AQUESTIVE THERAPEUTICS INC
AQUA - EVOQUA WATER TECHNOLOGIES CO
AR - ANTERO RESOURCES CORP
ARAV - ARAVIVE INC
ARAY - ACCURAY INC
ARBE - ARBE ROBOTICS LTD
ARBG - AEQUI ACQUISITION CORP-CL A
ARC - ARC DOCUMENT SOLUTIONS INC
ARCB - ARCBEST CORP
ARCC - ARES CAPITAL CORP
ARCE - ARCO PLATFORM LTD - CLASS A
ARCH - ARCH RESOURCES INC
ARCK - ARBOR RAPHA CAPITAL BIOHOLDI
ARCO - ARCOS DORADOS HOLDINGS INC-A
ARCT - ARCTURUS THERAPEUTICS HOLDIN
ARDS - ARIDIS PHARMACEUTICALS INC
ARDX - ARDELYX INC
AREC - AMERICAN RESOURCES CORP
ARES - ARES MANAGEMENT CORP - A
ARGO - ARGO GROUP INTERNATIONAL
ARGU - ARGUS CAPITAL CORP-CL A
ARHS - ARHAUS INC
ARIS - ARIS WATER SOLUTION INC-A
ARIZ - ARISZ ACQUISITION CORP
ARKO - ARKO CORP
ARKR - ARK RESTAURANTS CORP
ARL - AMERICAN REALTY INVESTORS IN
ARLO - ARLO TECHNOLOGIES INC
ARMK - ARAMARK
ARNA - ARENA PHARMACEUTICALS INC
ARNC - ARCONIC CORP
AROC - ARCHROCK INC
AROW - ARROW FINANCIAL CORP
ARQQ - ARQIT QUANTUM INC
ARQT - ARCUTIS BIOTHERAPEUTICS INC
ARRW - ARROWROOT ACQUISITION CORP-A
ARRY - ARRAY TECHNOLOGIES INC
ARTA - ARTISAN ACQUISITION CORP-A
ARTE - ARTEMIS STRATEGIC INVES-CL A
ARTL - ARTELO BIOSCIENCES INC
ARTNA - ARTESIAN RESOURCES CORP-CL A
ARTW - ART'S-WAY MANUFACTURING CO
ARVL - ARRIVAL SA
ARVN - ARVINAS INC
ARW - ARROW ELECTRONICS INC
ARWR - ARROWHEAD PHARMACEUTICALS IN
ARYD - ARYA SCIENCES ACQUISITION-A
ARYE - ARYA SCIENCES ACQUISITION -A
ASAN - ASANA INC - CL A
ASAQ - ATLANTIC AVENUE ACQUISI-CL A
ASAX - ASTREA ACQUISITION CORP-CL A
ASB - ASSOCIATED BANC-CORP
ASC - ARDMORE SHIPPING CORP
ASGN - ASGN INC
ASH - ASHLAND GLOBAL HOLDINGS INC
ASIX - ADVANSIX INC
ASLE - AERSALE CORP
ASMB - ASSEMBLY BIOSCIENCES INC
ASO - ACADEMY SPORTS & OUTDOORS IN
ASPA - ABRI SPAC I INC
ASPC - ALPHA CAPITAL ACQUISITION-A
ASPN - ASPEN AEROGELS INC
ASPS - ALTISOURCE PORTFOLIO SOL
ASPU - ASPEN GROUP INC
ASRT - ASSERTIO HOLDINGS INC
ASRV - AMERISERV FINANCIAL INC
ASTC - ASTROTECH CORP
ASTE - ASTEC INDUSTRIES INC
ASTL - ALGOMA STEEL GROUP INC
ASTR - ASTRA SPACE INC
ASTS - AST SPACEMOBILE INC
ASUR - ASURE SOFTWARE INC
ASYS - AMTECH SYSTEMS INC
ASZ - AUSTERLITZ ACQUISITION COR-A
ATA - AMERICAS TECHNOLOGY ACQUISIT
ATAI - ATAI LIFE SCIENCES NV
ATAQ - ALTIMAR ACQUISITION CORP-A
ATC - ATOTECH LTD
ATCO - ATLAS CORP
ATCX - ATLAS TECHNICAL CONSULTANTS
ATEC - ALPHATEC HOLDINGS INC
ATEN - A10 NETWORKS INC
ATER - ATERIAN INC
ATEX - ANTERIX INC
ATGE - ADTALEM GLOBAL EDUCATION INC
ATH - ATHENE HOLDING LTD-CLASS A
ATHA - ATHIRA PHARMA INC
ATHN - ATHENA TECHNOLOGY ACQUISIT-A
ATHX - ATHERSYS INC
ATI - ALLEGHENY TECHNOLOGIES INC
ATIF - ATIF HOLDINGS LTD
ATIP - ATI PHYSICAL THERAPY INC
ATKR - ATKORE INC
ATLC - ATLANTICUS HOLDINGS CORP
ATLO - AMES NATIONAL CORP
ATMR - ALTIMAR ACQUISITION CORP -A
ATNF - 180 LIFE SCIENCES CORP
ATNI - ATN INTERNATIONAL INC
ATNX - ATHENEX INC
ATO - ATMOS ENERGY CORP
ATOM - ATOMERA INC
ATOS - ATOSSA THERAPEUTICS INC
ATR - APTARGROUP INC
ATRA - ATARA BIOTHERAPEUTICS INC
ATRC - ATRICURE INC
ATRI - ATRION CORPORATION
ATRO - ASTRONICS CORP
ATRS - ANTARES PHARMA INC
ATSG - AIR TRANSPORT SERVICES GROUP
ATTO - ATENTO SA
ATUS - ALTICE USA INC- A
ATVC - TRIBE CAPITAL GROWTH CORP-A
ATVI - ACTIVISION BLIZZARD INC
ATXI - AVENUE THERAPEUTICS INC
ATXS - ASTRIA THERAPEUTICS INC
ATY - ACUITYADS HOLDING INC
AUB - ATLANTIC UNION BANKSHARES CO
AUBN - AUBURN NATL BANCORPORATION
AUD - AUDACY INC
AUDC - AUDIOCODES LTD
AUGX - AUGMEDIX INC
AUID - IPSIDY INC
AUPH - AURINIA PHARMACEUTICALS INC
AUR - AURORA INNOVATION INC
AURA - AURA BIOSCIENCES INC
AURC - AURORA ACQUISITION CORP-A
AUS - AUSTERLITZ ACQUISITION COR-A
AUTO - AUTOWEB INC
AUUD - AUDDIA INC
AUVI - APPLIED UV INC
AUY - YAMANA GOLD INC
AVA - AVISTA CORP
AVAC - AVALON ACQUISITION INC-A
AVAH - AVEANNA HEALTHCARE HOLDINGS
AVAN - AVANTI ACQUISITION CORP-A
AVAV - AEROVIRONMENT INC
AVCO - AVALON GLOBOCARE CORP
AVCT - AMERICAN VIRTUAL CLOUD TECHN
AVD - AMERICAN VANGUARD CORP
AVDX - AVIDXCHANGE HOLDINGS INC
AVEO - AVEO PHARMACEUTICALS INC
AVGO - BROADCOM INC
AVGR - AVINGER INC
AVHI - ACHARI VENTURES HOLDINGS COR
AVID - AVID TECHNOLOGY INC
AVIR - ATEA PHARMACEUTICALS INC
AVLR - AVALARA INC
AVNS - AVANOS MEDICAL INC
AVNT - AVIENT CORP
AVNW - AVIAT NETWORKS INC
AVO - MISSION PRODUCE INC
AVPT - AVEPOINT INC
AVRO - AVROBIO INC
AVT - AVNET INC
AVTE - AEROVATE THERAPEUTICS INC
AVTR - AVANTOR INC
AVTX - AVALO THERAPEUTICS INC
AVXL - ANAVEX LIFE SCIENCES CORP
AVY - AVERY DENNISON CORP
AVYA - AVAYA HOLDINGS CORP
AWH - ASPIRA WOMEN'S HEALTH INC
AWI - ARMSTRONG WORLD INDUSTRIES
AWK - AMERICAN WATER WORKS CO INC
AWR - AMERICAN STATES WATER CO
AWRE - AWARE INC/MASS
AX - AXOS FINANCIAL INC
AXDX - ACCELERATE DIAGNOSTICS INC
AXGN - AXOGEN INC
AXH - INDUSTRIAL HUMAN CAPITAL INC
AXL - AMERICAN AXLE & MFG HOLDINGS
AXLA - AXCELLA HEALTH INC
AXNX - AXONICS INC
AXON - AXON ENTERPRISE INC
AXP - AMERICAN EXPRESS CO
AXR - AMREP CORP
AXS - AXIS CAPITAL HOLDINGS LTD
AXSM - AXSOME THERAPEUTICS INC
AXTA - AXALTA COATING SYSTEMS LTD
AXTI - AXT INC
AY - ATLANTICA SUSTAINABLE INFRAS
AYI - ACUITY BRANDS INC
AYLA - AYALA PHARMACEUTICALS INC
AYRO - AYRO INC
AYTU - AYTU BIOPHARMA INC
AYX - ALTERYX INC - CLASS A
AZEK - AZEK CO INC/THE
AZO - AUTOZONE INC
AZPN - ASPEN TECHNOLOGY INC
AZRE - AZURE POWER GLOBAL LTD
AZTA - AZENTA INC
AZYO - AZIYO BIOLOGICS INC-CLASS A
AZZ - AZZ INC
B - BARNES GROUP INC
BA - BOEING CO/THE
BAC - BANK OF AMERICA CORP
BACA - BERENSON ACQUISITION CO-CL A
BAFN - BAYFIRST FINANCIAL CORP
BAH - BOOZ ALLEN HAMILTON HOLDINGS
BALY - BALLY'S CORP
BAM - BROOKFIELD ASSET MANAGE-CL A
BAMR - BROOKFIELD ASSET MANAGEMEN-A
BANC - BANC OF CALIFORNIA INC
BAND - BANDWIDTH INC-CLASS A
BANF - BANCFIRST CORP
BANR - BANNER CORPORATION
BANX - STONECASTLE FINANCIAL CORP
BAOS - BAOSHENG MEDIA GROUP HOLDING
BAP - CREDICORP LTD
BARK - BARK INC
BASE - COUCHBASE INC
BAX - BAXTER INTERNATIONAL INC
BB - BLACKBERRY LTD
BBAI - BIGBEAR.AI HOLDINGS INC
BBBY - BED BATH & BEYOND INC
BBCP - CONCRETE PUMPING HOLDINGS IN
BBDC - BARINGS BDC INC
BBGI - BEASLEY BROADCAST GRP INC -A
BBI - BRICKELL BIOTECH INC
BBIG - VINCO VENTURES INC
BBIO - BRIDGEBIO PHARMA INC
BBLG - BONE BIOLOGICS CORP
BBLN - BABYLON HOLDINGS LTD- CL A
BBQ - BBQ HOLDINGS INC
BBSI - BARRETT BUSINESS SVCS INC
BBW - BUILD-A-BEAR WORKSHOP INC
BBWI - BATH & BODY WORKS INC
BBY - BEST BUY CO INC
BC - BRUNSWICK CORP
BCAB - BIOATLA INC
BCAC - BROOKLINE CAPITAL ACQUISITIO
BCBP - BCB BANCORP INC
BCC - BOISE CASCADE CO
BCDA - BIOCARDIA INC
BCE - BCE INC
BCEL - ATRECA INC - A
BCLI - BRAINSTORM CELL THERAPEUTICS
BCML - BAYCOM CORP
BCO - BRINK'S CO/THE
BCOR - BLUCORA INC
BCOV - BRIGHTCOVE
BCOW - 1895 BANCORP OF WISCONSIN IN
BCPC - BALCHEM CORP
BCRX - BIOCRYST PHARMACEUTICALS INC
BCSF - BAIN CAPITAL SPECIALTY FINAN
BCTX - BRIACELL THERAPEUTICS CORP
BDC - BELDEN INC
BDSI - BIODELIVERY SCIENCES INTL
BDSX - BIODESIX INC
BDTX - BLACK DIAMOND THERAPEUTICS I
BDX - BECTON DICKINSON AND CO
BE - BLOOM ENERGY CORP- A
BEAM - BEAM THERAPEUTICS INC
BEAT - HEARTBEAM INC
BECN - BEACON ROOFING SUPPLY INC
BEEM - BEAM GLOBAL
BELFA - BEL FUSE INC-CL A
BELFB - BEL FUSE INC-CL B
BEN - FRANKLIN RESOURCES INC
BENE - BENESSERE CAPITAL ACQUI-CL A
BEPC - BROOKFIELD RENEWABLE COR-A
BERY - BERRY GLOBAL GROUP INC
BF.A - BROWN-FORMAN CORP-CLASS A
BF.B - BROWN-FORMAN CORP-CLASS B
BFAM - BRIGHT HORIZONS FAMILY SOLUT
BFC - BANK FIRST CORP
BFI - BURGERFI INTERNATIONAL INC
BFIN - BANKFINANCIAL CORP
BFLY - BUTTERFLY NETWORK INC
BFRI - BIOFRONTERA INC
BFST - BUSINESS FIRST BANCSHARES
BG - BUNGE LTD
BGCP - BGC PARTNERS INC-CL A
BGFV - BIG 5 SPORTING GOODS CORP
BGRY - BERKSHIRE GREY INC
BGS - B&G FOODS INC
BGSF - BGSF INC
BGSX - BUILD ACQUISITION CORP-A
BH - BIGLARI HOLDINGS INC-B
BH.A - BIGLARI HOLDINGS INC-A
BHAC - CRIXUS BH3 ACQUISITION CO-A
BHAT - BLUE HAT INTERACTIVE ENTERTA
BHC - BAUSCH HEALTH COS INC
BHE - BENCHMARK ELECTRONICS INC
BHF - BRIGHTHOUSE FINANCIAL INC
BHG - BRIGHT HEALTH GROUP INC
BHIL - BENSON HILL INC
BHLB - BERKSHIRE HILLS BANCORP INC
BHSE - BULL HORN HOLDINGS CORP
BHVN - BIOHAVEN PHARMACEUTICAL HOLD
BIG - BIG LOTS INC
BIGC - BIGCOMMERCE HOLDINGS-SER 1
BIIB - BIOGEN INC
BILL - BILL.COM HOLDINGS INC
BIMI - BIMI INTERNATIONAL MEDICAL I
BIO - BIO-RAD LABORATORIES-A
BIO.B - BIO-RAD LABORATORIES -CL B
BIOC - BIOCEPT INC
BIOL - BIOLASE INC
BIOT - BIOTECH ACQUISITION CO-CL A
BIOX - BIOCERES CROP SOLUTIONS CORP
BIPC - BROOKFIELD INFRASTRUCTURE-A
BIRD - ALLBIRDS INC-CL A
BITE - BITE ACQUISITION CORP
BITF - BITFARMS LTD/CANADA
BIVI - BIOVIE INC
BJ - BJ'S WHOLESALE CLUB HOLDINGS
BJDX - BLUEJAY DIAGNOSTICS INC
BJRI - BJ'S RESTAURANTS INC
BK - BANK OF NEW YORK MELLON CORP
BKCC - BLACKROCK CAPITAL INVESTMENT
BKD - BROOKDALE SENIOR LIVING INC
BKE - BUCKLE INC/THE
BKH - BLACK HILLS CORP
BKI - BLACK KNIGHT INC
BKKT - BAKKT HOLDINGS INC
BKNG - BOOKING HOLDINGS INC
BKR - BAKER HUGHES CO
BKSC - BANK OF SOUTH CAROLINA CORP
BKSY - BLACKSKY TECHNOLOGY INC
BKU - BANKUNITED INC
BKYI - BIO-KEY INTERNATIONAL INC
BL - BLACKLINE INC
BLBD - BLUE BIRD CORP
BLBX - BLACKBOXSTOCKS INC
BLCM - BELLICUM PHARMACEUTICALS INC
BLD - TOPBUILD CORP
BLDE - BLADE AIR MOBILITY INC
BLDP - BALLARD POWER SYSTEMS INC
BLDR - BUILDERS FIRSTSOURCE INC
BLFS - BIOLIFE SOLUTIONS INC
BLFY - BLUE FOUNDRY BANCORP
BLI - BERKELEY LIGHTS INC
BLIN - BRIDGELINE DIGITAL INC
BLK - BLACKROCK INC
BLKB - BLACKBAUD INC
BLL - BALL CORP
BLMN - BLOOMIN' BRANDS INC
BLND - BLEND LABS INC-A
BLNG - BELONG ACQUISITION CORP-A
BLNK - BLINK CHARGING CO
BLPH - BELLEROPHON THERAPEUTICS INC
BLSA - BCLS ACQUISITION CORP- CL A
BLTS - BRIGHT LIGHTS ACQUISITI-CL A
BLU - BELLUS HEALTH INC
BLUA - BLUERIVER ACQUISITION CORP-A
BLUE - BLUEBIRD BIO INC
BLX - BANCO LATINOAMERICANO COME-E
BLZE - BACKBLAZE INC-A
BMAC - BLACK MOUNTAIN ACQUISITION-A
BMAQ - BLOCKCHAIN MOON ACQUISITION
BMBL - BUMBLE INC-A
BMEA - BIOMEA FUSION INC
BMI - BADGER METER INC
BMO - BANK OF MONTREAL
BMRA - BIOMERICA INC
BMRC - BANK OF MARIN BANCORP/CA
BMRN - BIOMARIN PHARMACEUTICAL INC
BMTC - BRYN MAWR BANK CORP
BMY - BRISTOL-MYERS SQUIBB CO
BNED - BARNES & NOBLE EDUCATION INC
BNFT - BENEFITFOCUS INC
BNGO - BIONANO GENOMICS INC
BNIX - BANNIX ACQUISITION CORP
BNNR - BANNER ACQUISITION CORP
BNS - BANK OF NOVA SCOTIA
BNSO - BONSO ELECTRONICS INTL INC
BNTC - BENITEC BIOPHARMA INC
BOAC - BLUESCAPE OPPORTUNITIES AC-A
BOAS - BOA ACQUISITION CORP-A
BODY - BEACHBODY CO INC/THE
BOH - BANK OF HAWAII CORP
BOKF - BOK FINANCIAL CORPORATION
BOLT - BOLT BIOTHERAPEUTICS INC
BOMN - BOSTON OMAHA CORP-CL A
BON - BON NATURAL LIFE LTD
BOOM - DMC GLOBAL INC
BOOT - BOOT BARN HOLDINGS INC
BORR - BORR DRILLING LTD
BOSC - BOS BETTER ON-LINE SOLUTIONS
BOTJ - BANK OF THE JAMES FINANCIAL
BOWL - BOWLERO CORP
BOX - BOX INC - CLASS A
BOXD - BOXED INC
BOXL - BOXLIGHT CORP - CLASS A
BPMC - BLUEPRINT MEDICINES CORP
BPOP - POPULAR INC
BPRN - THE BANK OF PRINCETON
BPTH - BIO-PATH HOLDINGS INC
BR - BROADRIDGE FINANCIAL SOLUTIO
BRAG - BRAGG GAMING GROUP INC
BRBR - BELLRING BRANDS INC-CLASS A
BRC - BRADY CORPORATION - CL A
BRCN - BURCON NUTRASCIENCE CORP
BRDG - BRIDGE INVESTMENT GRP HDS-A
BRDS - BIRD GLOBAL INC-CLASS A
BREZ - BREEZE HOLDINGS ACQUISITION
BRID - BRIDGFORD FOODS CORP
BRIV - B RILEY PRINCIPAL 250 MERG-A
BRK.A - BERKSHIRE HATHAWAY INC-CL A
BRK.B - BERKSHIRE HATHAWAY INC-CL B
BRKL - BROOKLINE BANCORP INC
BRKR - BRUKER CORP
BRLI - BRILLIANT ACQUISITION CORP
BRLT - BRILLIANT EARTH GROUP INC-A
BRO - BROWN & BROWN INC
BROG - BROOGE ENERGY LTD
BROS - DUTCH BROS INC-CLASS A
BRP - BRP GROUP INC-A
BRPM - B RILEY PRINCIPAL 150 MERG-A
BRQS - BORQS TECHNOLOGIES INC
BRTX - BIORESTORATIVE THERAPIES INC
BRY - BERRY CORP
BRZE - BRAZE INC-A
BSAQ - BLACK SPADE ACQUISITION CO-A
BSBK - BOGOTA FINANCIAL CORP
BSET - BASSETT FURNITURE INDS
BSFC - BLUE STAR FOODS CORP
BSGA - BLUE SAFARI GROUP ACQUISIT-A
BSGM - BIOSIG TECHNOLOGIES INC
BSIG - BRIGHTSPHERE INVESTMENT GROU
BSKY - BIG SKY GROWTH PARTNERS IN-A
BSQR - BSQUARE CORP
BSRR - SIERRA BANCORP
BSVN - BANK7 CORP
BSX - BOSTON SCIENTIFIC CORP
BSY - BENTLEY SYSTEMS INC-CLASS B
BTAI - BIOXCEL THERAPEUTICS INC
BTAQ - BURGUNDY TECHNOLOGY ACQUIS-A
BTB - BIT BROTHER LTD
BTBD - BT BRANDS INC
BTBT - BIT DIGITAL INC
BTCS - BTCS INC
BTCY - BIOTRICITY INC
BTNB - BRIDGETOWN 2 HOLDINGS LTD-A
BTRS - BTRS HOLDINGS INC
BTTX - BETTER THERAPEUTICS INC
BTU - PEABODY ENERGY CORP
BTWN - BRIDGETOWN HOLDINGS LTD-CL A
BTX - BROOKLYN IMMUNOTHERAPEUTICS
BUR - BURFORD CAPITAL LTD
BURL - BURLINGTON STORES INC
BUSE - FIRST BUSEY CORP
BV - BRIGHTVIEW HOLDINGS INC
BVH - BLUEGREEN VACATIONS HOLDING
BVS - BIOVENTUS INC - A
BW - BABCOCK & WILCOX ENTERPR
BWA - BORGWARNER INC
BWAC - BETTER WORLD ACQUISITION COR
BWB - BRIDGEWATER BANCSHARES INC
BWC - BLUE WHALE ACQUISITION COR-A
BWEN - BROADWIND INC
BWFG - BANKWELL FINANCIAL GROUP INC
BWMN - BOWMAN CONSULTING GROUP LTD
BWMX - BETTERWARE DE MEXICO SAB DE
BWXT - BWX TECHNOLOGIES INC
BX - BLACKSTONE INC
BXC - BLUELINX HOLDINGS INC
BXRX - BAUDAX BIO INC
BXSL - BLACKSTONE SECURED LENDING F
BY - BYLINE BANCORP INC
BYD - BOYD GAMING CORP
BYFC - BROADWAY FINANCIAL CORP/DE
BYND - BEYOND MEAT INC
BYRN - BYRNA TECHNOLOGIES INC
BYSI - BEYONDSPRING INC
BYTS - BYTE ACQUISITION CORP - A
BZFD - BUZZFEED INC
BZH - BEAZER HOMES USA INC
C - CITIGROUP INC
CAAP - CORP AMERICA AIRPORTS SA
CAAS - CHINA AUTOMOTIVE SYSTEMS INC
CABA - CABALETTA BIO INC
CABO - CABLE ONE INC
CAC - CAMDEN NATIONAL CORP
CACC - CREDIT ACCEPTANCE CORP
CACI - CACI INTERNATIONAL INC -CL A
CADE - CADENCE BANK
CADL - CANDEL THERAPEUTICS INC
CAE - CAE INC
CAG - CONAGRA BRANDS INC
CAH - CARDINAL HEALTH INC
CAKE - CHEESECAKE FACTORY INC/THE
CAL - CALERES INC
CALA - CALITHERA BIOSCIENCES INC
CALB - CALIFORNIA BANCORP INC
CALM - CAL-MAINE FOODS INC
CALX - CALIX INC
CAMP - CALAMP CORP
CAMT - CAMTEK LTD
CANO - CANO HEALTH INC
CAPR - CAPRICOR THERAPEUTICS INC
CAR - AVIS BUDGET GROUP INC
CARA - CARA THERAPEUTICS INC
CARE - CARTER BANKSHARES INC
CARG - CARGURUS INC
CARR - CARRIER GLOBAL CORP
CARS - CARS.COM INC
CARV - CARVER BANCORP INC
CAS - CASCADE ACQUISITION COR-CL A
CASA - CASA SYSTEMS INC
CASH - META FINANCIAL GROUP INC
CASI - CASI PHARMACEUTICALS INC
CASS - CASS INFORMATION SYSTEMS INC
CASY - CASEY'S GENERAL STORES INC
CAT - CATERPILLAR INC
CATC - CAMBRIDGE BANCORP
CATO - CATO CORP-CLASS A
CATY - CATHAY GENERAL BANCORP
CB - CHUBB LTD
CBAN - COLONY BANKCORP
CBAT - CBAK ENERGY TECHNOLOGY INC
CBAY - CYMABAY THERAPEUTICS INC
CBFV - CB FINANCIAL SERVICES INC
CBIO - CATALYST BIOSCIENCES INC
CBNK - CAPITAL BANCORP INC/MD
CBRE - CBRE GROUP INC - A
CBRL - CRACKER BARREL OLD COUNTRY
CBSH - COMMERCE BANCSHARES INC
CBT - CABOT CORP
CBTX - CBTX INC
CBU - COMMUNITY BANK SYSTEM INC
CBZ - CBIZ INC
CC - CHEMOURS CO/THE
CCAC - CITIC CAPITAL ACQUISITION-A
CCAI - CASCADIA ACQUISITION CO-CL A
CCAP - CRESCENT CAPITAL BDC INC
CCB - COASTAL FINANCIAL CORP/WA
CCBG - CAPITAL CITY BANK GROUP INC
CCCC - C4 THERAPEUTICS INC
CCCS - CCC INTELLIGENT SOLUTIONS HO
CCEL - CRYO-CELL INTL INC
CCEP - COCA-COLA EUROPACIFIC PARTNE
CCJ - CAMECO CORP
CCK - CROWN HOLDINGS INC
CCL - CARNIVAL CORP
CCMP - CMC MATERIALS INC
CCNC - CODE CHAIN NEW CONTINENT LTD
CCNE - CNB FINANCIAL CORP/PA
CCO - CLEAR CHANNEL OUTDOOR HOLDIN
CCOI - COGENT COMMUNICATIONS HOLDIN
CCRN - CROSS COUNTRY HEALTHCARE INC
CCS - CENTURY COMMUNITIES INC
CCSI - CONSENSUS CLOUD SOLUTION
CCV - CHURCHILL CAPITAL CORP V-A
CCVI - CHURCHILL CAPITAL CORP VI-A
CCXI - CHEMOCENTRYX INC
CDAK - CODIAK BIOSCIENCES INC
CDAQ - COMPASS DIGITAL ACQUISITION
CDAY - CERIDIAN HCM HOLDING INC
CDE - COEUR MINING INC
CDEV - CENTENNIAL RESOURCE DEVELO-A
CDK - CDK GLOBAL INC
CDLX - CARDLYTICS INC
CDMO - AVID BIOSERVICES INC
CDNA - CAREDX INC
CDNS - CADENCE DESIGN SYS INC
CDRE - CADRE HOLDINGS INC
CDRO - CODERE ONLINE LUXEMBOURG SA
CDTX - CIDARA THERAPEUTICS INC
CDW - CDW CORP/DE
CDXC - CHROMADEX CORP
CDXS - CODEXIS INC
CDZI - CADIZ INC
CE - CELANESE CORP
CECE - CECO ENVIRONMENTAL CORP
CEIX - CONSOL ENERGY INC
CELC - CELCUITY INC
CELH - CELSIUS HOLDINGS INC
CELU - CELULARITY INC
CELZ - CREATIVE MEDICAL TECHNOLOGY
CEMI - CHEMBIO DIAGNOSTICS INC
CENQ - CENAQ ENERGY CORP-CLASS A
CENT - CENTRAL GARDEN & PET CO
CENTA - CENTRAL GARDEN AND PET CO-A
CENX - CENTURY ALUMINUM COMPANY
CERE - CEREVEL THERAPEUTICS HOLDING
CERN - CERNER CORP
CERS - CERUS CORP
CERT - CERTARA INC
CETX - CEMTREX INC
CEVA - CEVA INC
CF - CF INDUSTRIES HOLDINGS INC
CFB - CROSSFIRST BANKSHARES INC
CFBK - CF BANKSHARES INC
CFFE - CF ACQUISITION CORP VIII-A
CFFI - C & F FINANCIAL CORP
CFFN - CAPITOL FEDERAL FINANCIAL IN
CFG - CITIZENS FINANCIAL GROUP
CFIV - CF ACQUISITION CORP IV-CL A
CFLT - CONFLUENT INC-CLASS A
CFMS - CONFORMIS INC
CFR - CULLEN/FROST BANKERS INC
CFRX - CONTRAFECT CORP
CFV - CF ACQUISITION CORP V-A
CFVI - CF ACQUISITION CORP VI-CLS A
CFX - COLFAX CORP
CG - CARLYLE GROUP INC/THE
CGA - CHINA GREEN AGRICULTURE INC
CGAU - CENTERRA GOLD INC
CGBD - TCG BDC INC
CGC - CANOPY GROWTH CORP
CGEM - CULLINAN ONCOLOGY INC
CGEN - COMPUGEN LTD
CGNT - COGNYTE SOFTWARE LTD
CGNX - COGNEX CORP
CGRN - CAPSTONE GREEN ENERGY CORP
CGTX - COGNITION THERAPEUTICS INC
CHAA - CATCHA INVESTMENT CORP-A
CHCI - COMSTOCK HOLDING COMPANIES
CHCO - CITY HOLDING CO
CHD - CHURCH & DWIGHT CO INC
CHDN - CHURCHILL DOWNS INC
CHE - CHEMED CORP
CHEF - CHEFS' WAREHOUSE INC/THE
CHEK - CHECK CAP LTD
CHGG - CHEGG INC
CHH - CHOICE HOTELS INTL INC
CHK - CHESAPEAKE ENERGY CORP
CHKP - CHECK POINT SOFTWARE TECH
CHMG - CHEMUNG FINANCIAL CORP
CHNG - CHANGE HEALTHCARE INC
CHNR - CHINA NATURAL RESOURCES INC
CHPM - CHP MERGER CORP-CLASS A
CHPT - CHARGEPOINT HOLDINGS INC
CHRA - CHARAH SOLUTIONS INC
CHRS - COHERUS BIOSCIENCES INC
CHRW - C.H. ROBINSON WORLDWIDE INC
CHS - CHICO'S FAS INC
CHTR - CHARTER COMMUNICATIONS INC-A
CHUY - CHUY'S HOLDINGS INC
CHWA - CHW ACQUISITION CORP
CHWY - CHEWY INC - CLASS A
CHX - CHAMPIONX CORP
CI - CIGNA CORP
CIA - CITIZENS INC
CIDM - CINEDIGM CORP - A
CIEN - CIENA CORP
CIFR - CIPHER MINING INC
CIGI - COLLIERS INTERNATIONAL GROUP
CIIG - CIIG CAPITAL PARTNERS II-A
CINF - CINCINNATI FINANCIAL CORP
CING - CINGULATE INC
CINT - CI&T INC/UNITED STATES-A
CION - CION INVESTMENT CORP
CIR - CIRCOR INTERNATIONAL INC
CIT - CIT GROUP INC
CIVB - CIVISTA BANCSHARES INC
CIVI - CIVITAS RESOURCES INC
CIXX - CI FINANCIAL CORP
CIZN - CITIZENS HOLDING COMPANY
CJJD - CHINA JO-JO DRUGSTORES HOLDI
CKPT - CHECKPOINT THERAPEUTICS INC
CL - COLGATE-PALMOLIVE CO
CLAA - COLONNADE ACQUISITION CORP-A
CLAQ - CLEANTECH ACQUISITION CORP
CLAR - CLARUS CORP
CLAS - CLASS ACCELERATION CORP-A
CLAY - CHAVANT CAPITAL ACQ CORP
CLB - CORE LABORATORIES N.V.
CLBK - COLUMBIA FINANCIAL INC
CLBR - COLOMBIER ACQUISITION CORP-A
CLBS - CALADRIUS BIOSCIENCES INC
CLBT - CELLEBRITE DI LTD
CLDX - CELLDEX THERAPEUTICS INC
CLEU - CHINA LIBERAL EDUCATION HOLD
CLF - CLEVELAND-CLIFFS INC
CLFD - CLEARFIELD INC
CLGN - COLLPLANT BIOTECHNOLOGIES LT
CLH - CLEAN HARBORS INC
CLIM - CLIMATE REAL IMPACT SOLUTI-A
CLIR - CLEARSIGN TECHNOLOGIES CORP
CLNE - CLEAN ENERGY FUELS CORP
CLNN - CLENE INC
CLOE - CLOVER LEAF CAPITAL CORP -A
CLOV - CLOVER HEALTH INVESTMENTS CO
CLPS - CLPS INC
CLPT - CLEARPOINT NEURO INC
CLR - CONTINENTAL RESOURCES INC/OK
CLRB - CELLECTAR BIOSCIENCES INC
CLRM - CLARIM ACQUISITION CORP-CL A
CLRO - CLEARONE INC
CLS - CELESTICA INC
CLSD - CLEARSIDE BIOMEDICAL INC
CLSK - CLEANSPARK INC
CLSN - CELSION CORP
CLST - CATALYST BANCORP INC
CLVR - CLEVER LEAVES HOLDINGS INC
CLVS - CLOVIS ONCOLOGY INC
CLVT - CLARIVATE PLC
CLW - CLEARWATER PAPER CORP
CLWT - EURO TECH HOLDINGS CO LTD
CLX - CLOROX COMPANY
CLXT - CALYXT INC
CM - CAN IMPERIAL BK OF COMMERCE
CMA - COMERICA INC
CMAX - CAREMAX INC
CMBM - CAMBIUM NETWORKS CORP
CMC - COMMERCIAL METALS CO
CMCO - COLUMBUS MCKINNON CORP/NY
CMCSA - COMCAST CORP-CLASS A
CME - CME GROUP INC
CMG - CHIPOTLE MEXICAN GRILL INC
CMI - CUMMINS INC
CMLS - CUMULUS MEDIA INC-CL A
CMP - COMPASS MINERALS INTERNATION
CMPI - CHECKMATE PHARMACEUTICALS IN
CMPR - CIMPRESS PLC
CMPX - COMPASS THERAPEUTICS INC
CMRE - COSTAMARE INC
CMRX - CHIMERIX INC
CMS - CMS ENERGY CORP
CMTG - CLAROS MORTGAGE TRUST INC
CMTL - COMTECH TELECOMMUNICATIONS
CNA - CNA FINANCIAL CORP
CNC - CENTENE CORP
CNCE - CONCERT PHARMACEUTICALS INC
CND - CONCORD ACQUISITION CORP -A
CNDA - CONCORD ACQUISITION CORP -A
CNDT - CONDUENT INC
CNET - ZW DATA ACTION TECHNOLOGIES
CNEY - CN ENERGY GROUP INC
CNFR - CONIFER HOLDINGS INC
CNHI - CNH INDUSTRIAL NV
CNI - CANADIAN NATL RAILWAY CO
CNK - CINEMARK HOLDINGS INC
CNM - CORE & MAIN INC-CLASS A
CNMD - CONMED CORP
CNNB - CINCINNATI BANCORP INC
CNNE - CANNAE HOLDINGS INC
CNO - CNO FINANCIAL GROUP INC
CNOB - CONNECTONE BANCORP INC
CNP - CENTERPOINT ENERGY INC
CNQ - CANADIAN NATURAL RESOURCES
CNR - CORNERSTONE BUILDING BRANDS
CNS - COHEN & STEERS INC
CNSL - CONSOLIDATED COMMUNICATIONS
CNSP - CNS PHARMACEUTICALS INC
CNTG - CENTOGENE NV
CNTQ - CHARDAN NEXTECH ACQUISITION
CNTX - CONTEXT THERAPEUTICS INC
CNTY - CENTURY CASINOS INC
CNVY - CONVEY HEALTH SOLUTIONS HOLD
CNX - CNX RESOURCES CORP
CNXC - CONCENTRIX CORP
CNXN - PC CONNECTION INC
CO - GLOBAL CORD BLOOD CORP
COCO - VITA COCO CO INC/THE
COCP - COCRYSTAL PHARMA INC
CODA - CODA OCTOPUS GROUP INC
CODI - COMPASS DIVERSIFIED HOLDINGS
CODX - CO-DIAGNOSTICS INC
COF - CAPITAL ONE FINANCIAL CORP
COFS - CHOICEONE FINANCIAL SVCS INC
COGT - COGENT BIOSCIENCES INC
COHR - COHERENT INC
COHU - COHU INC
COIN - COINBASE GLOBAL INC -CLASS A
COKE - COCA-COLA CONSOLIDATED INC
COLB - COLUMBIA BANKING SYSTEM INC
COLI - COLICITY INC-A
COLL - COLLEGIUM PHARMACEUTICAL INC
COLM - COLUMBIA SPORTSWEAR CO
COMM - COMMSCOPE HOLDING CO INC
COMP - COMPASS INC - CLASS A
COMS - COMSOVEREIGN HOLDING CORP
CONN - CONN'S INC
CONX - CONX CORP-CLASS A SHARES
COO - COOPER COS INC/THE
COOK - TRAEGER INC
COOL - CORNER GROWTH ACQUISITION-A
COOP - MR COOPER GROUP INC
COP - CONOCOPHILLIPS
CORS - CORSAIR PARTNERING CORP -A
CORT - CORCEPT THERAPEUTICS INC
COST - COSTCO WHOLESALE CORP
COTY - COTY INC-CL A
COUP - COUPA SOFTWARE INC
COUR - COURSERA INC
COVA - CRESCENT COVE ACQUISITION-A
COWN - COWEN INC - A
CP - CANADIAN PACIFIC RAILWAY LTD
CPA - COPA HOLDINGS SA-CLASS A
CPAA - CONYERS PARK III ACQUISITI-A
CPAR - CATALYST PARTNERS ACQ-A
CPB - CAMPBELL SOUP CO
CPE - CALLON PETROLEUM CO
CPF - CENTRAL PACIFIC FINANCIAL CO
CPG - CRESCENT POINT ENERGY CORP
CPHC - CANTERBURY PARK HOLDING CORP
CPIX - CUMBERLAND PHARMACEUTICALS
CPK - CHESAPEAKE UTILITIES CORP
CPNG - COUPANG INC
CPOP - POP CULTURE GROUP CO LTD-A
CPRI - CAPRI HOLDINGS LTD
CPRT - COPART INC
CPRX - CATALYST PHARMACEUTICALS INC
CPS - COOPER-STANDARD HOLDING
CPSH - CPS TECHNOLOGIES CORP
CPSI - COMPUTER PROGRAMS & SYSTEMS
CPSR - CAPSTAR SPECIAL PURPOSE AC-A
CPSS - CONSUMER PORTFOLIO SERVICES
CPTK - CROWN PROPTECH ACQUISITION-A
CPUH - COMPUTE HEALTH ACQUISITION-A
CR - CRANE CO
CRAI - CRA INTERNATIONAL INC
CRBP - CORBUS PHARMACEUTICALS HOLDI
CRBU - CARIBOU BIOSCIENCES INC
CRC - CALIFORNIA RESOURCES CORP
CRCT - CRICUT INC - CLASS A
CRD.A - CRAWFORD & COMPANY -CL A
CRD.B - CRAWFORD & CO  -CL B
CRDF - CARDIFF ONCOLOGY INC
CRDL - CARDIOL THERAPEUTICS INC-A
CREG - CHINA RECYCLING ENERGY CORP
CREX - CREATIVE REALITIES INC
CRGY - CRESCENT ENERGY INC-A
CRHC - COHN ROBBINS HOLDINGS-CL A
CRI - CARTER'S INC
CRIS - CURIS INC
CRK - COMSTOCK RESOURCES INC
CRKN - CROWN ELECTROKINETICS CORP
CRL - CHARLES RIVER LABORATORIES
CRM - SALESFORCE.COM INC
CRMD - CORMEDIX INC
CRMT - AMERICA'S CAR-MART INC
CRNC - CERENCE INC
CRNT - CERAGON NETWORKS LTD
CRNX - CRINETICS PHARMACEUTICALS IN
CRON - CRONOS GROUP INC
CROX - CROCS INC
CRS - CARPENTER TECHNOLOGY
CRSP - CRISPR THERAPEUTICS AG
CRSR - CORSAIR GAMING INC
CRTD - CREATD INC
CRTX - CORTEXYME INC
CRU - CRUCIBLE ACQUISITION CORP-A
CRUS - CIRRUS LOGIC INC
CRVL - CORVEL CORP
CRVS - CORVUS PHARMACEUTICALS INC
CRWD - CROWDSTRIKE HOLDINGS INC - A
CRWS - CROWN CRAFTS INC
CRXT - CLARUS THERAPEUTICS HOLDINGS
CRY - CRYOLIFE INC
CRZN - CORAZON CAPITAL V838 MONOC-A
CSBR - CHAMPIONS ONCOLOGY INC
CSCO - CISCO SYSTEMS INC
CSCW - COLOR STAR TECHNOLOGY CO LTD
CSGP - COSTAR GROUP INC
CSGS - CSG SYSTEMS INTL INC
CSII - CARDIOVASCULAR SYSTEMS INC
CSIQ - CANADIAN SOLAR INC
CSL - CARLISLE COS INC
CSLT - CASTLIGHT HEALTH INC-B
CSPI - CSP INC
CSPR - CASPER SLEEP INC
CSSE - CHICKEN SOUP FOR THE SOUL EN
CSTA - CONSTELLATION ACQUISITION-A
CSTE - CAESARSTONE LTD
CSTL - CASTLE BIOSCIENCES INC
CSTM - CONSTELLIUM SE
CSTR - CAPSTAR FINANCIAL HOLDINGS I
CSV - CARRIAGE SERVICES INC
CSWC - CAPITAL SOUTHWEST CORP
CSWI - CSW INDUSTRIALS INC
CSX - CSX CORP
CTAQ - CARNEY TECHNOLOGY ACQU- CL A
CTAS - CINTAS CORP
CTBI - COMMUNITY TRUST BANCORP INC
CTG - COMPUTER TASK GROUP INC
CTHR - CHARLES & COLVARD LTD
CTIB - YUNHONG CTI LTD
CTIC - CTI BIOPHARMA CORP
CTKB - CYTEK BIOSCIENCES INC
CTLP - CANTALOUPE INC
CTLT - CATALENT INC
CTMX - CYTOMX THERAPEUTICS INC
CTOS - CUSTOM TRUCK ONE SOURCE INC
CTRA - COTERRA ENERGY INC
CTRM - CASTOR MARITIME INC
CTRN - CITI TRENDS INC
CTS - CTS CORP
CTSH - COGNIZANT TECH SOLUTIONS-A
CTSO - CYTOSORBENTS CORP
CTV - INNOVID CORP
CTVA - CORTEVA INC
CTXR - CITIUS PHARMACEUTICALS INC
CTXS - CITRIX SYSTEMS INC
CUBI - CUSTOMERS BANCORP INC
CUE - CUE BIOPHARMA INC
CUEN - CUENTAS INC
CULL - CULLMAN BANCORP INC/MD
CULP - CULP INC
CURI - CURIOSITYSTREAM INC
CURO - CURO GROUP HOLDINGS CORP
CURV - TORRID HOLDINGS INC
CUTR - CUTERA INC
CVAC - CUREVAC NV
CVBF - CVB FINANCIAL CORP
CVCO - CAVCO INDUSTRIES INC
CVCY - CENTRAL VALLEY COMM BANCORP
CVE - CENOVUS ENERGY INC
CVEO - CIVEO CORP
CVET - COVETRUS INC
CVGI - COMMERCIAL VEHICLE GROUP INC
CVGW - CALAVO GROWERS INC
CVI - CVR ENERGY INC
CVII - CHURCHILL CAPITAL CORP VII-A
CVLG - COVENANT LOGISTICS GROUP INC
CVLT - COMMVAULT SYSTEMS INC
CVLY - CODORUS VALLEY BANCORP INC
CVNA - CARVANA CO
CVRX - CVRX INC
CVS - CVS HEALTH CORP
CVT - CVENT HOLDING CORP
CVV - CVD EQUIPMENT CORP
CVX - CHEVRON CORP
CW - CURTISS-WRIGHT CORP
CWAN - CLEARWATER ANALYTICS HDS-A
CWBC - COMMUNITY WEST BANCSHARES
CWBR - COHBAR INC
CWCO - CONSOLIDATED WATER CO-ORD SH
CWEN - CLEARWAY ENERGY INC-C
CWEN.A - CLEARWAY ENERGY INC-A
CWH - CAMPING WORLD HOLDINGS INC-A
CWK - CUSHMAN & WAKEFIELD PLC
CWST - CASELLA WASTE SYSTEMS INC-A
CWT - CALIFORNIA WATER SERVICE GRP
CXDO - CREXENDO INC
CXM - SPRINKLR INC-A
CXW - CORECIVIC INC
CYAN - CYANOTECH CORP
CYBE - CYBEROPTICS CORP
CYBR - CYBERARK SOFTWARE LTD/ISRAEL
CYCC - CYCLACEL PHARMACEUTICALS INC
CYCN - CYCLERION THERAPEUTICS INC
CYD - CHINA YUCHAI INTL LTD
CYH - COMMUNITY HEALTH SYSTEMS INC
CYN - CYNGN INC
CYRN - CYREN LTD
CYRX - CRYOPORT INC
CYT - CYTEIR THERAPEUTICS INC
CYTH - CYCLO THERAPEUTICS INC
CYTK - CYTOKINETICS INC
CYTO - ALTAMIRA THERAPEUTICS LTD
CYXT - CYXTERA TECHNOLOGIES INC
CZNC - CITIZENS & NORTHERN CORP
CZOO - CAZOO GROUP LTD
CZR - CAESARS ENTERTAINMENT INC
CZWI - CITIZENS COMMUNITY BANCORP I
D - DOMINION ENERGY INC
DAC - DANAOS CORP
DAIO - DATA I/O CORP
DAKT - DAKTRONICS INC
DAL - DELTA AIR LINES INC
DALN - DALLASNEWS CORP
DALS - DA32 LIFE SCIENCE TECH ACQ-A
DAN - DANA INC
DAR - DARLING INGREDIENTS INC
DARE - DARE BIOSCIENCE INC
DASH - DOORDASH INC - A
DATS - DATCHAT INC
DAWN - DAY ONE BIOPHARMACEUTICALS I
DB - DEUTSCHE BANK AG-REGISTERED
DBD - DIEBOLD NIXDORF INC
DBDR - ROMAN DBDR TECH ACQUISITI-A
DBGI - DIGITAL BRANDS GROUP INC
DBI - DESIGNER BRANDS INC-CLASS A
DBTX - DECIBEL THERAPEUTICS INC
DBX - DROPBOX INC-CLASS A
DCBO - DOCEBO INC
DCGO - DOCGO INC
DCI - DONALDSON CO INC
DCO - DUCOMMUN INC
DCOM - DIME COMMUNITY BANCSHARES IN
DCPH - DECIPHERA PHARMACEUTICALS IN
DCRD - DECARBONIZATION PLUS ACQUI-A
DCRN - DECARBONIZATION PLUS ACQUI-A
DCT - DUCK CREEK TECHNOLOGIES INC
DCTH - DELCATH SYSTEMS INC
DD - DUPONT DE NEMOURS INC
DDD - 3D SYSTEMS CORP
DDOG - DATADOG INC - CLASS A
DDS - DILLARDS INC-CL A
DE - DEERE & CO
DECK - DECKERS OUTDOOR CORP
DELL - DELL TECHNOLOGIES -C
DEN - DENBURY INC
DENN - DENNY'S CORP
DERM - JOURNEY MEDICAL CORP
DESP - DESPEGAR.COM CORP
DFFN - DIFFUSION PHARMACEUTICALS IN
DFH - DREAM FINDERS HOMES INC - A
DFIN - DONNELLEY FINANCIAL SOLUTION
DFS - DISCOVER FINANCIAL SERVICES
DG - DOLLAR GENERAL CORP
DGHI - DIGIHOST TECHNOLOGY INC
DGICA - DONEGAL GROUP INC-CL A
DGICB - DONEGAL GROUP INC-B
DGII - DIGI INTERNATIONAL INC
DGLY - DIGITAL ALLY INC
DGNU - DRAGONEER GROWTH OPP III-A
DGX - QUEST DIAGNOSTICS INC
DH - DEFINITIVE HEALTHCARE CORP
DHBC - DHB CAPITAL CORP-CL A
DHCA - DHC ACQUISITION CORP-A
DHHC - DIAMONDHEAD HOLDINGS CORP-A
DHI - DR HORTON INC
DHIL - DIAMOND HILL INVESTMENT GRP
DHR - DANAHER CORP
DHT - DHT HOLDINGS INC
DHX - DHI GROUP INC
DIBS - 1STDIBS.COM INC
DICE - DICE THERAPEUTICS INC
DILA - DILA CAPITAL ACQUISITION - A
DIN - DINE BRANDS GLOBAL INC
DIOD - DIODES INC
DIS - WALT DISNEY CO/THE
DISA - DISRUPTIVE ACQUISITION COR-A
DISCA - DISCOVERY INC - A
DISCB - DISCOVERY INC-B
DISCK - DISCOVERY INC-C
DISH - DISH NETWORK CORP-A
DJCO - DAILY JOURNAL CORP
DK - DELEK US HOLDINGS INC
DKDCA - DATA KNIGHTS ACQUISITION C-A
DKNG - DRAFTKINGS INC - CL A
DKS - DICK'S SPORTING GOODS INC
DLB - DOLBY LABORATORIES INC-CL A
DLCA - DEEP LAKE CAPITAL ACQUIS-CLA
DLHC - DLH HOLDINGS CORP
DLO - DLOCAL LTD
DLPN - DOLPHIN ENTERTAINMENT INC
DLTH - DULUTH HOLDINGS INC - CL B
DLTR - DOLLAR TREE INC
DLX - DELUXE CORP
DM - DESKTOP METAL INC-A
DMAC - DIAMEDICA THERAPEUTICS INC
DMAQ - DEEP MEDICINE ACQUISITI-CL A
DMRC - DIGIMARC CORP
DMS - DIGITAL MEDIA SOLUTIONS-A
DMTK - DERMTECH INC
DMYS - DMY TECHNOLOGY GROUP INC VI
DNA - GINKGO BIOWORKS HOLDINGS INC
DNAA - SOCIAL CAPITAL SUVRETTA HO-A
DNAB - SOCIAL CAPITAL SUVRETTA HO-A
DNAC - SOCIAL CAPITAL SUVRETTA HO-A
DNAD - SOCIAL CAPITAL SUVRETTA HO-A
DNAY - CODEX DNA INC
DNB - DUN & BRADSTREET HOLDINGS IN
DNLI - DENALI THERAPEUTICS INC
DNMR - DANIMER SCIENTIFIC INC
DNOW - NOW INC
DNUT - KRISPY KREME INC
DNZ - D AND Z MEDIA ACQUISITION-A
DOCN - DIGITALOCEAN HOLDINGS INC
DOCS - DOXIMITY INC-CLASS A
DOCU - DOCUSIGN INC
DOGZ - DOGNESS INTERNATIONAL CORP-A
DOLE - DOLE PLC
DOMA - DOMA HOLDINGS INC
DOMO - DOMO INC - CLASS B
DOOO - BRP INC/CA- SUB VOTING
DOOR - MASONITE INTERNATIONAL CORP
DORM - DORMAN PRODUCTS INC
DOV - DOVER CORP
DOW - DOW INC
DOX - AMDOCS LTD
DPRO - DRAGANFLY INC
DPZ - DOMINO'S PIZZA INC
DRAY - MACONDRAY CAPITAL AC-CLASS A
DRI - DARDEN RESTAURANTS INC
DRIO - DARIOHEALTH CORP
DRMA - DERMATA THERAPEUTICS INC
DRNA - DICERNA PHARMACEUTICALS INC
DRQ - DRIL-QUIP INC
DRRX - DURECT CORPORATION
DRTT - DIRTT ENVIRONMENTAL SOLUTION
DRUG - BRIGHT MINDS BIOSCIENCES INC
DRVN - DRIVEN BRANDS HOLDINGS INC
DS - DRIVE SHACK INC
DSAC - DUDDELL STREET ACQUISITION-A
DSAQ - DIRECT SELLING ACQUISITION-A
DSEY - DIVERSEY HOLDINGS LTD
DSGN - DESIGN THERAPEUTICS INC
DSGX - DESCARTES SYSTEMS GRP/THE
DSKE - DASEKE INC
DSP - VIANT TECHNOLOGY INC-A
DSWL - DESWELL INDUSTRIES INC
DSX - DIANA SHIPPING INC
DT - DYNATRACE INC
DTC - SOLO BRANDS INC - CLASS A
DTE - DTE ENERGY COMPANY
DTEA - DAVIDSTEA INC
DTIL - PRECISION BIOSCIENCES INC
DTM - DT MIDSTREAM INC
DTOC - DIGITAL TRANSFORMATION OPP-A
DTRT - DTRT HEALTH ACQ CORP-A
DTSS - DATASEA INC
DTST - DATA STORAGE CORP
DUK - DUKE ENERGY CORP
DUNE - DUNE ACQUISITION CORP-CL A
DUOL - DUOLINGO
DUOT - DUOS TECHNOLOGIES GROUP INC
DV - DOUBLEVERIFY HOLDINGS INC
DVA - DAVITA INC
DVAX - DYNAVAX TECHNOLOGIES CORP
DVN - DEVON ENERGY CORP
DWAC - DIGITAL WORLD ACQUISITION-A
DWIN - DELWINDS INSURANCE - CLASS A
DWSN - DAWSON GEOPHYSICAL CO
DXC - DXC TECHNOLOGY CO
DXCM - DEXCOM INC
DXLG - DESTINATION XL GROUP INC
DXPE - DXP ENTERPRISES INC
DXYN - DIXIE GROUP INC
DY - DYCOM INDUSTRIES INC
DYAI - DYADIC INTERNATIONAL INC
DYN - DYNE THERAPEUTICS INC
DYNS - DYNAMICS SPECIAL PURPOSE C-A
DYNT - DYNATRONICS CORP
DZSI - DZS INC
EA - ELECTRONIC ARTS INC
EAC - EDIFY ACQUISITION CORP-CL A
EAF - GRAFTECH INTERNATIONAL LTD
EAR - EARGO INC
EAST - EASTSIDE DISTILLING INC
EAT - BRINKER INTERNATIONAL INC
EB - EVENTBRITE INC-CLASS A
EBAC - EUROPEAN BIOTECH ACQUISITI-A
EBAY - EBAY INC
EBC - EASTERN BANKSHARES INC
EBET - ESPORTS TECHNOLOGIES INC
EBF - ENNIS INC
EBIX - EBIX INC
EBMT - EAGLE BANCORP MONTANA INC
EBON - EBANG INTERNATIONAL HLDGS-A
EBS - EMERGENT BIOSOLUTIONS INC
EBTC - ENTERPRISE BANCORP INC
ECL - ECOLAB INC
ECOL - US ECOLOGY INC
ECOM - CHANNELADVISOR CORP
ECOR - ELECTROCORE INC
ECPG - ENCORE CAPITAL GROUP INC
ECVT - ECOVYST INC
ED - CONSOLIDATED EDISON INC
EDIT - EDITAS MEDICINE INC
EDNC - ENDURANCE ACQUISITIO-CLASS A
EDR - ENDEAVOR GROUP HOLD-CLASS A
EDRY - EURODRY LTD
EDSA - EDESA BIOTECH INC
EDTK - SKILLFUL CRAFTSMAN EDUCATION
EDTX - EDTECHX HOLDINGS II-CLASS A
EDUC - EDUCATIONAL DEVELOPMENT CORP
EEFT - EURONET WORLDWIDE INC
EEIQ - ELITE EDUCATION GROUP INTERN
EEX - EMERALD HOLDING INC
EFOI - ENERGY FOCUS INC
EFSC - ENTERPRISE FINANCIAL SERVICE
EFTR - EFFECTOR THERAPEUTICS INC
EFX - EQUIFAX INC
EGAN - EGAIN CORP
EGBN - EAGLE BANCORP INC
EGGF - EG ACQUISITION CORP-A
EGHT - 8X8 INC
EGLE - EAGLE BULK SHIPPING INC
EGLX - ENTHUSIAST GAMING HOLDINGS I
EGO - ELDORADO GOLD CORP
EGRX - EAGLE PHARMACEUTICALS INC
EGY - VAALCO ENERGY INC
EHC - ENCOMPASS HEALTH CORP
EHTH - EHEALTH INC
EIG - EMPLOYERS HOLDINGS INC
EIGR - EIGER BIOPHARMACEUTICALS INC
EIX - EDISON INTERNATIONAL
EJFA - EJF ACQUISITION CORP-A
EJH - E-HOME HOUSEHOLD SERVICE
EKSO - EKSO BIONICS HOLDINGS INC
EL - ESTEE LAUDER COMPANIES-CL A
ELAN - ELANCO ANIMAL HEALTH INC
ELDN - ELEDON PHARMACEUTICALS INC
ELEV - ELEVATION ONCOLOGY INC
ELF - ELF BEAUTY INC
ELMS - ELECTRIC LAST MILE SOLUTIONS
ELOX - ELOXX PHARMACEUTICALS INC
ELSE - ELECTRO-SENSORS INC
ELTK - ELTEK LTD
ELVT - ELEVATE CREDIT INC
ELY - CALLAWAY GOLF COMPANY
ELYM - ELIEM THERAPEUTICS INC
ELYS - ELYS GAME TECHNOLOGY CORP
EMBK - EMBARK TECHNOLOGY INC
EMCF - EMCLAIRE FINANCIAL CORP
EME - EMCOR GROUP INC
EMKR - EMCORE CORP
EML - EASTERN CO/THE
EMN - EASTMAN CHEMICAL CO
EMR - EMERSON ELECTRIC CO
ENB - ENBRIDGE INC
ENDP - ENDO INTERNATIONAL PLC
ENER - ACCRETION ACQUISITION CORP
ENFN - ENFUSION INC - CLASS A
ENG - ENGLOBAL CORP
ENJY - ENJOY TECHNOLOGY INC
ENLV - ENLIVEX THERAPEUTICS LTD
ENNV - ECP ENVIRONMENTAL GROWTH O-A
ENOB - ENOCHIAN BIOSCIENCES INC
ENPC - EXECUTIVE NETWORK PARTNER-A
ENPH - ENPHASE ENERGY INC
ENR - ENERGIZER HOLDINGS INC
ENS - ENERSYS
ENSC - ENSYSCE BIOSCIENCES INC
ENSG - ENSIGN GROUP INC/THE
ENTA - ENANTA PHARMACEUTICALS INC
ENTF - ENTERPRISE 4.0 TECHNOLOGY AC
ENTG - ENTEGRIS INC
ENTX - ENTERA BIO LTD
ENV - ENVESTNET INC
ENVA - ENOVA INTERNATIONAL INC
ENVB - ENVERIC BIOSCIENCES INC
ENVI - ENVIRONMENTAL IMPACT ACQUI-A
ENVX - ENOVIX CORP
ENZ - ENZO BIOCHEM INC
EOCW - ELLIOTT OPPORTUNITY II COR-A
EOG - EOG RESOURCES INC
EOLS - EVOLUS INC
EOSE - EOS ENERGY ENTERPRISES INC
EPAC - ENERPAC TOOL GROUP CORP
EPAM - EPAM SYSTEMS INC
EPAY - BOTTOMLINE TECHNOLOGIES (DE)
EPC - EDGEWELL PERSONAL CARE CO
EPHY - EPIPHANY TECHNOLOGY ACQ-CL A
EPIX - ESSA PHARMA INC
EPSN - EPSILON ENERGY LTD
EPWR - EMPOWERMENT & INCLUSION-CL A
EPZM - EPIZYME INC
EQ - EQUILLIUM INC
EQBK - EQUITY BANCSHARES INC - CL A
EQD - EQUITY DISTRIBUTION ACQUIS-A
EQH - EQUITABLE HOLDINGS INC
EQHA - EQ HEALTH ACQUISITION CORP-A
EQOS - EQONEX LTD
EQRX - EQRX INC
EQS - EQUUS TOTAL RETURN INC
EQT - EQT CORP
ERAS - ERASCA INC
ERES - EAST RESOURCES ACQUISITION-A
ERF - ENERPLUS CORP
ERIE - ERIE INDEMNITY COMPANY-CL A
ERII - ENERGY RECOVERY INC
ERO - ERO COPPER CORP
ES - EVERSOURCE ENERGY
ESAC - ESGEN ACQUISITION CORP-A
ESBK - ELMIRA SAVINGS BANK
ESCA - ESCALADE INC
ESE - ESCO TECHNOLOGIES INC
ESEA - EUROSEAS LTD
ESGC - EROS STX GLOBAL CORP
ESGR - ENSTAR GROUP LTD
ESI - ELEMENT SOLUTIONS INC
ESLT - ELBIT SYSTEMS LTD
ESM - ESM ACQUISITION CORP-A
ESMT - ENGAGESMART INC
ESNT - ESSENT GROUP LTD
ESPR - ESPERION THERAPEUTICS INC
ESQ - ESQUIRE FINANCIAL HOLDINGS I
ESSA - ESSA BANCORP INC
ESSC - EAST STONE ACQUISITION CORP
ESTA - ESTABLISHMENT LABS HOLDINGS
ESTC - ELASTIC NV
ESTE - EARTHSTONE ENERGY INC - A
ETAC - E.MERGE TECHNOLOGY ACQUISI-A
ETD - ETHAN ALLEN INTERIORS INC
ETN - EATON CORP PLC
ETNB - 89BIO INC
ETON - ETON PHARMACEUTICALS INC
ETR - ENTERGY CORP
ETRN - EQUITRANS MIDSTREAM CORP
ETSY - ETSY INC
ETTX - ENTASIS THERAPEUTICS HOLDING
ETWO - E2OPEN PARENT HOLDINGS INC
EUCR - EUCRATES BIOMEDICAL ACQUISIT
EURN - EURONAV NV
EVBG - EVERBRIDGE INC
EVC - ENTRAVISION COMMUNICATIONS-A
EVCM - EVERCOMMERCE INC
EVER - EVERQUOTE INC - CLASS A
EVFM - EVOFEM BIOSCIENCES INC
EVGN - EVOGENE LTD
EVGO - EVGO INC
EVH - EVOLENT HEALTH INC - A
EVK - EVER-GLORY INTERNATIONAL GRO
EVLO - EVELO BIOSCIENCES INC
EVLV - EVOLV TECHNOLOGIES HOLDINGS
EVOJ - EVO ACQUISITION CORP-A
EVOK - EVOKE PHARMA INC
EVOL - EVOLVING SYSTEMS INC
EVOP - EVO PAYMENTS INC-CLASS A
EVR - EVERCORE INC - A
EVRG - EVERGY INC
EVRI - EVERI HOLDINGS INC
EVTC - EVERTEC INC
EVTL - VERTICAL AEROSPACE LTD
EW - EDWARDS LIFESCIENCES CORP
EWBC - EAST WEST BANCORP INC
EWCZ - EUROPEAN WAX CENTER INC-A
EWTX - EDGEWISE THERAPEUTICS INC
EXAS - EXACT SCIENCES CORP
EXC - EXELON CORP
EXEL - EXELIXIS INC
EXFY - EXPENSIFY INC - A
EXK - ENDEAVOUR SILVER CORP
EXLS - EXLSERVICE HOLDINGS INC
EXP - EAGLE MATERIALS INC
EXPD - EXPEDITORS INTL WASH INC
EXPE - EXPEDIA GROUP INC
EXPI - EXP WORLD HOLDINGS INC
EXPO - EXPONENT INC
EXPR - EXPRESS INC
EXTN - EXTERRAN CORP
EXTR - EXTREME NETWORKS INC
EYE - NATIONAL VISION HOLDINGS INC
EYEN - EYENOVIA INC
EYES - SECOND SIGHT MEDICAL PRODUCT
EYPT - EYEPOINT PHARMACEUTICALS INC
EZFL - EZFILL HOLDINGS INC
EZGO - EZGO TECHNOLOGIES LTD
EZPW - EZCORP INC-CL A
F - FORD MOTOR CO
FA - FIRST ADVANTAGE CORP
FACA - FIGURE ACQUISITION CORP I -A
FACT - FREEDOM ACQUISITION I CORP-A
FAF - FIRST AMERICAN FINANCIAL
FAMI - FARMMI INC
FANG - DIAMONDBACK ENERGY INC
FARM - FARMER BROS CO
FARO - FARO TECHNOLOGIES INC
FAST - FASTENAL CO
FAT - FAT BRANDS INC-CL A
FATBB - FAT BRANDS INC-CL B
FATE - FATE THERAPEUTICS INC
FATP - FAT PROJECTS ACQUISITION COR
FB - META PLATFORMS INC-CLASS A
FBC - FLAGSTAR BANCORP INC
FBHS - FORTUNE BRANDS HOME & SECURI
FBIO - FORTRESS BIOTECH INC
FBIZ - FIRST BUSINESS FINANCIAL SER
FBK - FB FINANCIAL CORP
FBMS - FIRST BANCSHARES INC/MS
FBNC - FIRST BANCORP/NC
FBP - FIRST BANCORP PUERTO RICO
FBRX - FORTE BIOSCIENCES INC
FC - FRANKLIN COVEY CO
FCAP - FIRST CAPITAL INC
FCAX - FORTRESS CAPITAL ACQUISITI-A
FCBC - FIRST COMMUNITY BANKSHARES
FCCO - FIRST COMMUNITY CORP
FCCY - 1ST CONSTITUTION BANCORP
FCEL - FUELCELL ENERGY INC
FCF - FIRST COMMONWEALTH FINL CORP
FCFS - FIRSTCASH HOLDINGS INC
FCN - FTI CONSULTING INC
FCNCA - FIRST CITIZENS BCSHS  -CL A
FCRD - FIRST EAGLE ALTERNATIVE CAPI
FCUV - FOCUS UNIVERSAL INC
FCX - FREEPORT-MCMORAN INC
FDBC - FIDELITY D&D BANCORP INC
FDMT - 4D MOLECULAR THERAPEUTICS IN
FDP - FRESH DEL MONTE PRODUCE INC
FDS - FACTSET RESEARCH SYSTEMS INC
FDUS - FIDUS INVESTMENT CORP
FDX - FEDEX CORP
FE - FIRSTENERGY CORP
FEIM - FREQUENCY ELECTRONICS INC
FELE - FRANKLIN ELECTRIC CO INC
FEMY - FEMASYS INC
FENC - FENNEC PHARMACEUTICALS INC
FERG - FERGUSON PLC
FET - FORUM ENERGY TECHNOLOGIES IN
FF - FUTUREFUEL CORP
FFBC - FIRST FINANCIAL BANCORP
FFBW - FFBW INC
FFHL - FUWEI FILMS HOLDINGS CO LTD
FFIC - FLUSHING FINANCIAL CORP
FFIE - FARADAY FUTURE INTELLIGENT E
FFIN - FIRST FINL BANKSHARES INC
FFIV - F5 INC
FFNW - FIRST FINANCIAL NORTHWEST
FFWM - FIRST FOUNDATION INC
FGBI - FIRST GUARANTY BANCSHARES IN
FGEN - FIBROGEN INC
FGF - FG FINANCIAL GROUP INC
FHB - FIRST HAWAIIAN INC
FHI - FEDERATED HERMES INC
FHLT - FUTURE HEALTH ESG CORP
FHN - FIRST HORIZON CORP
FHTX - FOGHORN THERAPEUTICS INC
FIAC - FOCUS IMPACT ACQUISITION-A
FIBK - FIRST INTERSTATE BANCSYS-A
FICO - FAIR ISAAC CORP
FICV - FRONTIER INVESTMENT CORP -A
FIGS - FIGS INC-CLASS A
FINM - MARLIN TECHNOLOGY CORP-A
FINW - FINWISE BANCORP
FIS - FIDELITY NATIONAL INFO SERV
FISI - FINANCIAL INSTITUTIONS INC
FISV - FISERV INC
FITB - FIFTH THIRD BANCORP
FIVE - FIVE BELOW
FIVN - FIVE9 INC
FIX - COMFORT SYSTEMS USA INC
FIXX - HOMOLOGY MEDICINES INC
FIZZ - NATIONAL BEVERAGE CORP
FKWL - FRANKLIN WIRELESS CORP
FL - FOOT LOCKER INC
FLAC - FRAZIER LIFESCIENCES ACQUI-A
FLAG - FIRST LIGHT ACQUISITION GR-A
FLDM - FLUIDIGM CORP
FLEX - FLEX LTD
FLGC - FLORA GROWTH CORP
FLGT - FULGENT GENETICS INC
FLIC - FIRST OF LONG ISLAND CORP
FLL - FULL HOUSE RESORTS INC
FLME - FLAME ACQUISITION CORP -CL A
FLMN - FALCON MINERALS CORP
FLNC - FLUENCE ENERGY INC
FLNG - FLEX LNG LTD
FLNT - FLUENT INC
FLO - FLOWERS FOODS INC
FLOW - SPX FLOW INC
FLR - FLUOR CORP
FLS - FLOWSERVE CORP
FLT - FLEETCOR TECHNOLOGIES INC
FLUX - FLUX POWER HOLDINGS INC
FLWS - 1-800-FLOWERS.COM INC-CL A
FLXS - FLEXSTEEL INDS
FLYA - SOAR TECHNOLOGY ACQUISITIO-A
FLYW - FLYWIRE CORP-VOTING
FMAC - FIRSTMARK HORIZON ACQUISIT-A
FMAO - FARMERS & MERCHANTS BANCO/OH
FMBH - FIRST MID BANCSHARES INC
FMBI - FIRST MIDWEST BANCORP INC/IL
FMC - FMC CORP
FMIV - FORUM MERGER IV CORP-A
FMNB - FARMERS NATL BANC CORP
FMTX - FORMA THERAPEUTICS HOLDINGS
FN - FABRINET
FNA - PARAGON 28 INC
FNB - FNB CORP
FNCB - FNCB BANCORP INC
FNCH - FINCH THERAPEUTICS GROUP INC
FND - FLOOR & DECOR HOLDINGS INC-A
FNF - FIDELITY NATIONAL FINANCIAL
FNHC - FEDNAT HOLDING CO
FNKO - FUNKO INC-CLASS A
FNLC - FIRST BANCORP INC/ME
FNV - FRANCO-NEVADA CORP
FNVT - FINNOVATE ACQUISITION CORP-A
FNWB - FIRST NORTHWEST BANCORP
FNWD - FINWARD BANCORP
FOA - FINANCE OF AMERICA COS INC-A
FOCS - FOCUS FINANCIAL PARTNERS-A
FOE - FERRO CORP
FOLD - AMICUS THERAPEUTICS INC
FONR - FONAR CORP
FOR - FORESTAR GROUP INC
FORA - FORIAN INC
FORD - FORWARD INDUSTRIES INC
FORG - FORGEROCK INC-A
FORM - FORMFACTOR INC
FORR - FORRESTER RESEARCH INC
FOSL - FOSSIL GROUP INC
FOUN - FOUNDER SPAC-CL A
FOUR - SHIFT4 PAYMENTS INC-CLASS A
FOX - FOX CORP - CLASS B
FOXA - FOX CORP - CLASS A
FOXF - FOX FACTORY HOLDING CORP
FOXW - FOXWAYNE ENTERPRISES ACQ- A
FPAC - FAR PEAK ACQUISITION CORP-A
FPAY - FLEXSHOPPER INC
FPH - FIVE POINT HOLDINGS LLC-CL A
FRAF - FRANKLIN FINANCIAL SERVICES
FRBA - FIRST BANK/HAMILTON NJ
FRBK - REPUBLIC FIRST BANCORP INC
FRC - FIRST REPUBLIC BANK/CA
FREE - WHOLE EARTH BRANDS INC
FREQ - FREQUENCY THERAPEUTICS INC
FREY - FREYR BATTERY SA
FRG - FRANCHISE GROUP INC
FRGI - FIESTA RESTAURANT GROUP
FRHC - FREEDOM HOLDING CORP/NV
FRME - FIRST MERCHANTS CORP
FRO - FRONTLINE LTD
FROG - JFROG LTD
FRON - FRONTIER ACQUISITION CORP-A
FRPH - FRP HOLDINGS INC
FRPT - FRESHPET INC
FRSG - FIRST RESERVE SUSTAINABLE-A
FRSH - FRESHWORKS INC-CL A
FRST - PRIMIS FINANCIAL CORP
FRTA - FORTERRA INC
FRW - PWP FORWARD ACQUISITION CO-A
FRXB - FOREST ROAD ACQUISITION CO-A
FSBC - FIVE STAR BANCORP
FSBW - FS BANCORP INC
FSEA - FIRST SEACOAST BANCORP
FSFG - FIRST SAVINGS FINANCIAL GRP
FSII - FS DEVELOPMENT CORP II-A
FSK - FS KKR CAPITAL CORP
FSLR - FIRST SOLAR INC
FSLY - FASTLY INC - CLASS A
FSM - FORTUNA SILVER MINES INC
FSNB - FUSION ACQUISITION CORP II-A
FSR - FISKER INC
FSRX - FINSERV ACQUISITION CORP-A
FSS - FEDERAL SIGNAL CORP
FSSI - FORTISTAR SUSTAINABLE SOLU-A
FST - FAST ACQUISITION CORP-CL A
FSTR - FOSTER (LB) CO-A
FSTX - F-STAR THERAPEUTICS INC
FSV - FIRSTSERVICE CORP
FTAA - FTAC ATHENA ACQUISITION CO-A
FTCH - FARFETCH LTD-CLASS A
FTCI - FTC SOLAR INC
FTCV - FINTECH ACQUISITION CORP V-A
FTDR - FRONTDOOR INC
FTEK - FUEL TECH INC
FTEV - FINTECH EVOLUTION ACQUISIT-A
FTFT - FUTURE FINTECH GROUP INC
FTHM - FATHOM HOLDINGS INC
FTI - TECHNIPFMC PLC
FTK - FLOTEK INDUSTRIES INC
FTNT - FORTINET INC
FTPA - FTAC PARNASSUS ACQUISITION-A
FTRP - FIELD TRIP HEALTH LTD
FTS - FORTIS INC
FTV - FORTIVE CORP
FTVI - FINTECH ACQUISITION CORP -A
FUBO - FUBOTV INC
FUL - H.B. FULLER CO.
FULC - FULCRUM THERAPEUTICS INC
FULT - FULTON FINANCIAL CORP
FUNC - FIRST UNITED CORP
FUSB - FIRST US BANCSHARES INC
FUSN - FUSION PHARMACEUTICALS INC
FUV - ARCIMOTO INC
FVAM - 5:01 ACQUISITION CORP- CL A
FVCB - FVCBANKCORP INC
FVE - FIVE STAR SENIOR LIVING INC
FVIV - FORTRESS VALUE ACQUIS IV-A
FVRR - FIVERR INTERNATIONAL LTD
FVT - FORTRESS VALUE ACQUISITION-A
FWAC - FIFTH WALL ACQUISITION COR-A
FWBI - FIRST WAVE BIOPHARMA
FWRD - FORWARD AIR CORP
FWRG - FIRST WATCH RESTAURANT GROUP
FXLV - F45 TRAINING HOLDINGS INC
FXNC - FIRST NATIONAL CORP/VA
FYBR - FRONTIER COMMUNICATIONS PARE
FZT - FAST ACQUISITION CORP II-A
G - GENPACT LTD
GABC - GERMAN AMERICAN BANCORP
GACQ - GLOBAL CONSUMER ACQUISITION
GAIA - GAIA INC
GAIN - GLADSTONE INVESTMENT CORP
GALT - GALECTIN THERAPEUTICS INC
GAMB - GAMBLING.COM GROUP LTD
GAMC - GOLDEN ARROW MERGER CORP-A
GAME - ENGINE GAMING AND MEDIA INC
GAN - GAN LTD
GANX - GAIN THERAPEUTICS INC
GAPA - G&P ACQUISITION CORP-CL A
GASS - STEALTHGAS INC
GATE - MARBLEGATE ACQUISITION COR-A
GATO - GATOS SILVER INC
GATX - GATX CORP
GB - GLOBAL BLUE GROUP HOLDING AG
GBCI - GLACIER BANCORP INC
GBDC - GOLUB CAPITAL BDC INC
GBIO - GENERATION BIO CO
GBL - GAMCO INVESTORS INC-A
GBLI - GLOBAL INDEMNITY GROUP LLC-A
GBNH - GREENBROOK TMS INC
GBNY - GENERATIONS BANCORP NY INC
GBOX - GREENBOX POS
GBRG - GOLDENBRIDGE ACQUISITION LTD
GBS - GBS INC
GBT - GLOBAL BLOOD THERAPEUTICS IN
GBX - GREENBRIER COMPANIES INC
GCAC - GROWTH CAPITAL ACQUISITION-A
GCBC - GREENE COUNTY BANCORP INC
GCI - GANNETT CO INC
GCMG - GCM GROSVENOR INC - CLASS A
GCO - GENESCO INC
GCP - GCP APPLIED TECHNOLOGIES
GD - GENERAL DYNAMICS CORP
GDDY - GODADDY INC - CLASS A
GDEN - GOLDEN ENTERTAINMENT INC
GDEV - NEXTERS INC
GDOT - GREEN DOT CORP-CLASS A
GDRX - GOODRX HOLDINGS INC-CLASS A
GDYN - GRID DYNAMICS HOLDINGS INC
GE - GENERAL ELECTRIC CO
GECC - GREAT ELM CAPITAL CORP
GEF - GREIF INC-CL A
GEF.B - GREIF INC-CL B
GEG - GREAT ELM GROUP INC
GENC - GENCOR INDUSTRIES INC
GENI - GENIUS SPORTS LTD
GEOS - GEOSPACE TECHNOLOGIES CORP
GERN - GERON CORP
GES - GUESS? INC
GEVO - GEVO INC
GFAI - GUARDFORCE AI CO LTD
GFED - GUARANTY FEDERAL BNCSHS INC
GFF - GRIFFON CORP
GFL - GFL ENVIRONMENTAL INC-SUB VT
GFOR - GRAF ACQUISITION CORP IV
GFS - GLOBALFOUNDRIES INC
GFX - GOLDEN FALCON ACQUISITI-CL A
GGG - GRACO INC
GGGV - G3 VRM ACQUISITION CORP-CL A
GGMC - GLENFARNE MERGER CORP-A
GGPI - GORES GUGGENHEIM INC -CL A
GH - GUARDANT HEALTH INC
GHAC - GAMING & HOSPITALITY ACQUI-A
GHC - GRAHAM HOLDINGS CO-CLASS B
GHL - GREENHILL & CO INC
GHLD - GUILD HOLDINGS CO - CLASS A
GHM - GRAHAM CORP
GHRS - GH RESEARCH PLC
GHSI - GUARDION HEALTH SCIENCES INC
GIA - GIGCAPITAL5 INC
GIAC - GESHER I ACQUISITION CORP-A
GIB - CGI INC
GIC - GLOBAL INDUSTRIAL CO
GIFI - GULF ISLAND FABRICATION INC
GIGM - GIGAMEDIA LTD
GIII - G-III APPAREL GROUP LTD
GIIX - GORES HOLDINGS VIII INC-CL A
GIL - GILDAN ACTIVEWEAR INC
GILD - GILEAD SCIENCES INC
GILT - GILAT SATELLITE NETWORKS LTD
GIPR - GENERATION INCOME PROPERTIES
GIS - GENERAL MILLS INC
GIW - GIGINTERNATIONAL1 INC
GKOS - GLAUKOS CORP
GL - GLOBE LIFE INC
GLAD - GLADSTONE CAPITAL CORP
GLAQ - GLOBIS ACQUISITION CORP
GLBE - GLOBAL-E ONLINE LTD
GLBL - CARTESIAN GROWTH CORP-A
GLBS - GLOBUS MARITIME LIMITED
GLBZ - GLEN BURNIE BANCORP
GLDD - GREAT LAKES DREDGE & DOCK CO
GLEE - GLADSTONE ACQUISITION CORP-A
GLG - TD HOLDINGS INC
GLHA - GLASS HOUSES ACQUISITION COR
GLMD - GALMED PHARMACEUTICALS LTD
GLNG - GOLAR LNG LTD
GLOB - GLOBANT SA
GLOP - GASLOG PARTNERS LP
GLRE - GREENLIGHT CAPITAL RE LTD-A
GLSI - GREENWICH LIFESCIENCES INC
GLT - GLATFELTER CORP
GLTO - GALECTO INC
GLUE - MONTE ROSA THERAPEUTICS INC
GLW - CORNING INC
GLYC - GLYCOMIMETICS INC
GM - GENERAL MOTORS CO
GMBL - ESPORTS ENTERTAINMENT GROUP
GMBT - QUEEN'S GAMBIT GROWTH -CL A
GMDA - GAMIDA CELL LTD
GME - GAMESTOP CORP-CLASS A
GMED - GLOBUS MEDICAL INC - A
GMII - GORES METROPOULOS II INC-A
GMS - GMS INC
GMTX - GEMINI THERAPEUTICS INC
GMVD - G MEDICAL INNOVATION HOLDING
GNAC - GROUP NINE ACQUISITION -CL A
GNCA - GENOCEA BIOSCIENCES INC
GNE - GENIE ENERGY LTD-B
GNK - GENCO SHIPPING & TRADING LTD
GNLN - GREENLANE HOLDINGS INC - A
GNOG - GOLDEN NUGGET ONLINE GAMING
GNPX - GENPREX INC
GNRC - GENERAC HOLDINGS INC
GNSS - GENASYS INC
GNTX - GENTEX CORP
GNTY - GUARANTY BANCSHARES INC
GNUS - GENIUS BRANDS INTERNATIONAL
GNW - GENWORTH FINANCIAL INC-CL A
GO - GROCERY OUTLET HOLDING CORP
GOAC - GO ACQUISITION CORP-CLASS A
GOBI - GOBI ACQUISITION CORP-A
GOCO - GOHEALTH INC-CLASS A
GOEV - CANOO INC
GOGL - GOLDEN OCEAN GROUP LTD
GOGN - GOGREEN INVESTMENTS CORP
GOGO - GOGO INC
GOLD - BARRICK GOLD CORP
GOLF - ACUSHNET HOLDINGS CORP
GOOG - ALPHABET INC-CL C
GOOGL - ALPHABET INC-CL A
GOOS - CANADA GOOSE HOLDINGS INC
GOSS - GOSSAMER BIO INC
GOVX - GEOVAX LABS INC
GP - GREENPOWER MOTOR CO INC
GPAC - GLOBAL PARTNER ACQUISITION-A
GPC - GENUINE PARTS CO
GPCO - GOLDEN PATH ACQUISITION CORP
GPI - GROUP 1 AUTOMOTIVE INC
GPK - GRAPHIC PACKAGING HOLDING CO
GPN - GLOBAL PAYMENTS INC
GPOR - GULFPORT ENERGY CORP
GPRE - GREEN PLAINS INC
GPRK - GEOPARK LTD
GPRO - GOPRO INC-CLASS A
GPS - GAP INC/THE
GRAB - GRAB HOLDINGS LTD - CL A
GRAY - GRAYBUG VISION INC
GRBK - GREEN BRICK PARTNERS INC
GRC - GORMAN-RUPP CO
GRCY - GREENCITY ACQUISITION CORP
GREE - GREENIDGE GENERATION HOLDING
GRIL - MUSCLE MAKER INC
GRIN - GRINDROD SHIPPING HOLDINGS L
GRMN - GARMIN LTD
GRNQ - GREENPRO CAPITAL CORP
GROM - GROM SOCIAL ENTERPRISES INC
GROW - U.S. GLOBAL INVESTORS INC-A
GRPH - GRAPHITE BIO INC
GRPN - GROUPON INC
GRTS - GRITSTONE BIO INC
GRTX - GALERA THERAPEUTICS INC
GRVI - GROVE INC
GRWG - GROWGENERATION CORP
GS - GOLDMAN SACHS GROUP INC
GSAQ - GLOBAL SYNERGY ACQUISITION-A
GSBC - GREAT SOUTHERN BANCORP INC
GSBD - GOLDMAN SACHS BDC INC
GSEV - GORES HOLDINGS VII INC-A
GSHD - GOOSEHEAD INSURANCE INC -A
GSIT - GSI TECHNOLOGY INC
GSKY - GREENSKY INC-CLASS A
GSL - GLOBAL SHIP LEASE INC-CL A
GSM - FERROGLOBE PLC
GSMG - GLORY STAR NEW MEDIA GROUP H
GSQB - G SQUARED ASCEND II INC -A
GSQD - G SQUARED ASCEND I INC-CL A
GT - GOODYEAR TIRE & RUBBER CO
GTAC - GLOBAL TECHNOLOGY ACQUISIT-A
GTBP - GT BIOPHARMA INC
GTEC - GREENLAND TECHNOLOGIES HOLDI
GTES - GATES INDUSTRIAL CORP PLC
GTHX - G1 THERAPEUTICS INC
GTIM - GOOD TIMES RESTAURANTS INC
GTLB - GITLAB INC-CL A
GTLS - CHART INDUSTRIES INC
GTN - GRAY TELEVISION INC
GTN.A - GRAY TELEVISION INC-A
GTPA - GORES TECHNOLOGY PARTNERS-A
GTPB - GORES TECHNOLOGY PRTNR II-A
GTS - TRIPLE-S MANAGEMENT CORP
GTX - GARRETT MOTION INC
GTYH - GTY TECHNOLOGY HOLDINGS INC
GURE - GULF RESOURCES INC
GVA - GRANITE CONSTRUCTION INC
GVP - GSE SYSTEMS INC
GWB - GREAT WESTERN BANCORP INC
GWGH - GWG HOLDINGS INC
GWH - ESS TECH INC
GWII - GOOD WORKS II ACQUISITION CO
GWRE - GUIDEWIRE SOFTWARE INC
GWRS - GLOBAL WATER RESOURCES INC
GWW - WW GRAINGER INC
GXII - GX ACQUISITION CORP II-A
GXO - GXO LOGISTICS INC
GYRO - GYRODYNE LLC
H - HYATT HOTELS CORP - CL A
HA - HAWAIIAN HOLDINGS INC
HAAC - HEALTH ASSURANCE ACQUISIT-A
HAE - HAEMONETICS CORP/MASS
HAFC - HANMI FINANCIAL CORPORATION
HAIN - HAIN CELESTIAL GROUP INC
HAL - HALLIBURTON CO
HALL - HALLMARK FINL SERVICES INC
HALO - HALOZYME THERAPEUTICS INC
HAPP - HAPPINESS DEVELOPMENT GROU-A
HARP - HARPOON THERAPEUTICS INC
HAS - HASBRO INC
HAYN - HAYNES INTERNATIONAL INC
HAYW - HAYWARD HOLDINGS INC
HBAN - HUNTINGTON BANCSHARES INC
HBB - HAMILTON BEACH BRAND-A
HBCP - HOME BANCORP INC
HBI - HANESBRANDS INC
HBIO - HARVARD BIOSCIENCE INC
HBM - HUDBAY MINERALS INC
HBMD - HOWARD BANCORP INC
HBNC - HORIZON BANCORP INC/IN
HBP - HUTTIG BUILDING PRODUCTS INC
HBT - HBT FINANCIAL INC/DE
HCA - HCA HEALTHCARE INC
HCAQ - HEALTHCOR CATALIO ACQUISIT-A
HCAR - HEALTHCARE SERVICES ACQUI-A
HCAT - HEALTH CATALYST INC
HCC - WARRIOR MET COAL INC
HCCC - HEALTHCARE CAPITAL CORP-CL A
HCCI - HERITAGE-CRYSTAL CLEAN INC
HCDI - HARBOR CUSTOM DEVELOPMENT
HCI - HCI GROUP INC
HCIC - HENNESSY CAPITAL INVESTMEN-A
HCII - HUDSON EXECUTIVE INVESTMENT
HCKT - HACKETT GROUP INC/THE
HCNE - JAWS HURRICANE ACQUISITION-A
HCP - HASHICORP INC-CL A
HCSG - HEALTHCARE SERVICES GROUP
HCTI - HEALTHCARE TRIANGLE INC
HCVI - HENNESSY CAPITAL INVEST-CL A
HCWB - HCW BIOLOGICS INC
HD - HOME DEPOT INC
HDSN - HUDSON TECHNOLOGIES INC
HE - HAWAIIAN ELECTRIC INDS
HEAR - TURTLE BEACH CORP
HEES - H&E EQUIPMENT SERVICES INC
HEI - HEICO CORP
HEI.A - HEICO CORP-CLASS A
HELE - HELEN OF TROY LTD
HEPA - HEPION PHARMACEUTICALS INC
HERA - FTAC HERA ACQUISITION CORP-A
HES - HESS CORP
HESM - HESS MIDSTREAM LP - CLASS A
HEXO - HEXO CORP
HFBL - HOME FEDERAL BANCORP INC/LA
HFC - HOLLYFRONTIER CORP
HFFG - HF FOODS GROUP INC
HFWA - HERITAGE FINANCIAL CORP
HGBL - HERITAGE GLOBAL INC
HGEN - HUMANIGEN INC
HGSH - CHINA HGS REAL ESTATE INC
HGTY - HAGERTY INC-A
HGV - HILTON GRAND VACATIONS INC
HHC - HOWARD HUGHES CORP/THE
HHGC - HHG CAPITAL CORP
HHLA - HH&L ACQUISITION CO -CLASS A
HHS - HARTE-HANKS INC
HI - HILLENBRAND INC
HIBB - HIBBETT INC
HIFS - HINGHAM INSTITUTION FOR SVGS
HIG - HARTFORD FINANCIAL SVCS GRP
HIGA - HIG ACQUISITION CORP-CLASS A
HIHO - HIGHWAY HOLDINGS LTD
HII - HUNTINGTON INGALLS INDUSTRIE
HIII - HUDSON EXECUTIVE INVESTMEN-A
HIL - HILL INTERNATIONAL INC
HIMS - HIMS & HERS HEALTH INC
HIPO - HIPPO HOLDINGS INC
HITI - HIGH TIDE INC
HIVE - HIVE BLOCKCHAIN TECHNOLOGIES
HL - HECLA MINING CO
HLAH - HAMILTON LANE ALL-CLASS A
HLBZ - HELBIZ INC
HLF - HERBALIFE NUTRITION LTD
HLI - HOULIHAN LOKEY INC
HLIO - HELIOS TECHNOLOGIES INC
HLIT - HARMONIC INC
HLLY - HOLLEY INC
HLMN - HILLMAN SOLUTIONS CORP
HLNE - HAMILTON LANE INC-CLASS A
HLT - HILTON WORLDWIDE HOLDINGS IN
HLTH - CUE HEALTH INC
HLX - HELIX ENERGY SOLUTIONS GROUP
HLXA - HELIX ACQUISITION CORP-A
HMCO - HUMANCO ACQUISITION COR-CL A
HMHC - HOUGHTON MIFFLIN HARCOURT CO
HMLP - HOEGH LNG PARTNERS LP
HMN - HORACE MANN EDUCATORS
HMNF - HMN FINANCIAL INC
HMPT - HOME POINT CAPITAL INC
HMST - HOMESTREET INC
HMTV - HEMISPHERE MEDIA GROUP INC
HNGR - HANGER INC
HNI - HNI CORP
HNNA - HENNESSY ADVISORS INC
HNRG - HALLADOR ENERGY CO
HNST - HONEST CO INC/THE
HOFT - HOOKER FURNISHINGS CORP
HOFV - HALL OF FAME RESORT & ENTERT
HOG - HARLEY-DAVIDSON INC
HOLI - HOLLYSYS AUTOMATION TECHNOLO
HOLX - HOLOGIC INC
HOMB - HOME BANCSHARES INC
HON - HONEYWELL INTERNATIONAL INC
HONE - HARBORONE BANCORP INC
HOOD - ROBINHOOD MARKETS INC - A
HOOK - HOOKIPA PHARMA INC
HOPE - HOPE BANCORP INC
HOTH - HOTH THERAPEUTICS INC
HOV - HOVNANIAN ENTERPRISES-A
HOWL - WEREWOLF THERAPEUTICS INC
HP - HELMERICH & PAYNE
HPE - HEWLETT PACKARD ENTERPRISE
HPK - HIGHPEAK ENERGY INC
HPLT - HOME PLATE ACQUISITION -CL A
HPQ - HP INC
HPX - HPX CORP-A
HQI - HIREQUEST INC
HQY - HEALTHEQUITY INC
HRB - H&R BLOCK INC
HRI - HERC HOLDINGS INC
HRL - HORMEL FOODS CORP
HRMY - HARMONY BIOSCIENCES HOLDINGS
HROW - HARROW HEALTH INC
HRT - HIRERIGHT HOLDINGS CORP
HRTG - HERITAGE INSURANCE HOLDINGS
HRTX - HERON THERAPEUTICS INC
HRZN - HORIZON TECHNOLOGY FINANCE C
HSAQ - HEALTH SCIENCES ACQUISITIONS
HSC - HARSCO CORP
HSDT - HELIUS MEDICAL TECHNOLOGIES
HSIC - HENRY SCHEIN INC
HSII - HEIDRICK & STRUGGLES INTL
HSKA - HESKA CORP
HSON - HUDSON GLOBAL INC
HSTM - HEALTHSTREAM INC
HSTO - HISTOGEN INC
HSY - HERSHEY CO/THE
HTBI - HOMETRUST BANCSHARES INC
HTBK - HERITAGE COMMERCE CORP
HTBX - HEAT BIOLOGICS INC
HTGC - HERCULES CAPITAL INC
HTGM - HTG MOLECULAR DIAGNOSTICS
HTH - HILLTOP HOLDINGS INC
HTLD - HEARTLAND EXPRESS INC
HTLF - HEARTLAND FINANCIAL USA INC
HTOO - FUSION FUEL GREEN PLC-A
HTPA - HIGHLAND TRANSCEND PART-CL A
HTZ - HERTZ GLOBAL HLDGS INC
HUBB - HUBBELL INC
HUBG - HUB GROUP INC-CL A
HUBS - HUBSPOT INC
HUDI - HUADI INTERNATIONAL GROUP CO
HUGE - FSD PHARMA INC-CLASS B
HUGS - USHG ACQUISITION CORP-A
HUM - HUMANA INC
HUMA - HUMACYTE INC
HUN - HUNTSMAN CORP
HURC - HURCO COMPANIES INC
HURN - HURON CONSULTING GROUP INC
HUSN - HUDSON CAPITAL INC
HUT - HUT 8 MINING CORP
HVBC - HV BANCORP INC
HVT - HAVERTY FURNITURE
HVT.A - HAVERTY FURNITURE COS-CL A
HWBK - HAWTHORN BANCSHARES INC
HWC - HANCOCK WHITNEY CORP
HWEL - HEALTHWELL ACQUISITION COR-A
HWKN - HAWKINS INC
HWKZ - HAWKS ACQUISITION CORP - A
HWM - HOWMET AEROSPACE INC
HXL - HEXCEL CORP
HY - HYSTER-YALE MATERIALS
HYAC - HAYMAKER ACQUISITION CORP-A
HYFM - HYDROFARM HOLDINGS GROUP INC
HYLN - HYLIION HOLDINGS CORP
HYMC - HYCROFT MINING HOLDING CORP
HYRE - HYRECAR INC
HYZN - HYZON MOTORS INC
HZN - HORIZON GLOBAL CORP
HZNP - HORIZON THERAPEUTICS PLC
HZO - MARINEMAX INC
HZON - HORIZON ACQUIS CORP II -CL A
IAA - IAA INC
IAC - IAC/INTERACTIVECORP
IACC - ION ACQUISITION CORP 3 LTD-A
IAG - IAMGOLD CORP
IART - INTEGRA LIFESCIENCES HOLDING
IAS - INTEGRAL AD SCIENCE HOLDING
IBCP - INDEPENDENT BANK CORP - MICH
IBER - IBERE PHARMACEUTICALS-A
IBEX - IBEX LTD
IBKR - INTERACTIVE BROKERS GRO-CL A
IBM - INTL BUSINESS MACHINES CORP
IBOC - INTERNATIONAL BANCSHARES CRP
IBP - INSTALLED BUILDING PRODUCTS
IBRX - IMMUNITYBIO INC
IBTX - INDEPENDENT BANK GROUP INC
ICAD - ICAD INC
ICCC - IMMUCELL CORP
ICCH - ICC HOLDINGS INC
ICCM - ICECURE MEDICAL LTD
ICD - INDEPENDENCE CONTRACT DRILLI
ICE - INTERCONTINENTAL EXCHANGE IN
ICFI - ICF INTERNATIONAL INC
ICHR - ICHOR HOLDINGS LTD
ICL - ICL GROUP LTD
ICLR - ICON PLC
ICMB - INVESTCORP CREDIT MANAGEMENT
ICNC - ICONIC SPORTS ACQ CORP-A
ICPT - INTERCEPT PHARMACEUTICALS IN
ICUI - ICU MEDICAL INC
ICVX - ICOSAVAX INC
IDA - IDACORP INC
IDCC - INTERDIGITAL INC
IDEX - IDEANOMICS INC
IDN - INTELLICHECK INC
IDRA - IDERA PHARMACEUTICALS INC
IDT - IDT CORP-CLASS B
IDXX - IDEXX LABORATORIES INC
IDYA - IDEAYA BIOSCIENCES INC
IEA - INFRASTRUCTURE AND ENERGY AL
IESC - IES HOLDINGS INC
IEX - IDEX CORP
IFBD - INFOBIRD CO LTD
IFF - INTL FLAVORS & FRAGRANCES
IFRX - INFLARX NV
IFS - INTERCORP FINANCIAL SERVICES
IGAC - IG ACQUISITION CORP-CLASS A
IGAP - INTEGRITY APPLICATIONS INC
IGIC - INTERNATIONAL GENERAL INSURA
IGMS - IGM BIOSCIENCES INC
IGNY - IGNYTE ACQUISITION CORP
IGT - INTERNATIONAL GAME TECHNOLOG
IHC - INDEPENDENCE HOLDING CO
IHRT - IHEARTMEDIA INC - CLASS A
IHS - IHS HOLDING LTD
III - INFORMATION SERVICES GROUP
IIII - INSU ACQUISITION CORP III-A
IIIN - INSTEEL INDUSTRIES INC
IIIV - I3 VERTICALS INC-CLASS A
IIN - INTRICON CORP
IINN - INSPIRA TECHNOLOGIES OXY BHN
IIVI - II-VI INC
IKNA - IKENA ONCOLOGY INC
IKT - INHIBIKASE THERAPEUTICS INC
ILMN - ILLUMINA INC
IMAC - IMAC HOLDINGS INC
IMAQ - INTERNATIONAL MEDIA ACQ-A
IMAX - IMAX CORP
IMBI - IMEDIA BRANDS INC
IMCC - IM CANNABIS CORP
IMGN - IMMUNOGEN INC
IMGO - IMAGO BIOSCIENCES INC
IMKTA - INGLES MARKETS INC-CLASS A
IMMR - IMMERSION CORPORATION
IMMX - IMMIX BIOPHARMA INC
IMNM - IMMUNOME INC
IMPL - IMPEL NEUROPHARMA INC
IMPP - IMPERIAL PETROLEUM INC-W/I
IMPX - AEA-BRIDGES IMPACT CORP-CL A
IMRA - IMARA INC
IMRX - IMMUNEERING CORP - CLASS A
IMTE - INTEGRATED MEDIA TECHNOLOGY
IMTX - IMMATICS NV
IMUX - IMMUNIC INC
IMV - IMV INC
IMVT - IMMUNOVANT INC
IMXI - INTERNATIONAL MONEY EXPRESS
INAB - IN8BIO INC
INAQ - INSIGHT ACQUISITION CORP-A
INBK - FIRST INTERNET BANCORP
INBX - INHIBRX INC
INCR - INTERCURE LTD
INCY - INCYTE CORP
INDB - INDEPENDENT BANK CORP/MA
INDI - INDIE SEMICONDUCTOR INC-A
INDP - INDAPTUS THERAPEUTICS INC
INFA - INFORMATICA INC - CLASS A
INFI - INFINITY PHARMACEUTICALS INC
INFN - INFINERA CORP
INFO - IHS MARKIT LTD
INGN - INOGEN INC
INGR - INGREDION INC
INKA - KLUDEIN I ACQUISITION CORP-A
INKT - MINK THERAPEUTICS INC
INM - INMED PHARMACEUTICALS INC
INMB - INMUNE BIO INC
INMD - INMODE LTD
INNV - INNOVAGE HOLDING CORP
INO - INOVIO PHARMACEUTICALS INC
INOD - INNODATA INC
INPX - INPIXON
INS - INTELLIGENT SYSTEMS CORP
INSE - INSPIRED ENTERTAINMENT INC
INSG - INSEEGO CORP
INSM - INSMED INC
INSP - INSPIRE MEDICAL SYSTEMS INC
INST - INSTRUCTURE HOLDINGS INC
INSW - INTERNATIONAL SEAWAYS INC
INT - WORLD FUEL SERVICES CORP
INTA - INTAPP INC
INTC - INTEL CORP
INTE - INTEGRAL ACQUISITION CORP-A
INTG - INTERGROUP CORP
INTU - INTUIT INC
INTZ - INTRUSION INC
INVA - INNOVIVA INC
INVE - IDENTIV INC
INVO - INVO BIOSCIENCE INC
INVZ - INNOVIZ TECHNOLOGIES LTD
INZY - INOZYME PHARMA INC
IO - ION GEOPHYSICAL CORP
IOBT - IO BIOTECH INC
IONM - ASSURE HOLDINGS CORP
IONQ - IONQ INC
IONS - IONIS PHARMACEUTICALS INC
IOSP - INNOSPEC INC
IOT - SAMSARA INC-CL A
IOVA - IOVANCE BIOTHERAPEUTICS INC
IP - INTERNATIONAL PAPER CO
IPA - IMMUNOPRECISE ANTIBODIES LTD
IPAR - INTER PARFUMS INC
IPAX - INFLECTION POINT ACQUISITI-A
IPDN - PROFESSIONAL DIVERSITY NETWO
IPG - INTERPUBLIC GROUP OF COS INC
IPGP - IPG PHOTONICS CORP
IPI - INTREPID POTASH INC
IPOD - SOCIAL CAPITAL HEDOSOPH- A
IPOF - SOCIAL CAPITAL HEDOSOPH VI-A
IPSC - CENTURY THERAPEUTICS INC
IPVA - INTERPRIVATE II ACQU-CLASS A
IPVF - INTERPRIVATE III FINANCIAL-A
IPVI - INTERPRIVATE IV INFRATECH-A
IPW - IPOWER INC
IPWR - IDEAL POWER INC
IQV - IQVIA HOLDINGS INC
IR - INGERSOLL-RAND INC
IRBT - IROBOT CORP
IRDM - IRIDIUM COMMUNICATIONS INC
IREN - IRIS ENERGY LTD
IRIX - IRIDEX CORP
IRMD - IRADIMED CORP
IRNT - IRONNET INC
IROQ - IF BANCORP INC
IRTC - IRHYTHM TECHNOLOGIES INC
IRWD - IRONWOOD PHARMACEUTICALS INC
IS - IRONSOURCE LTD-A
ISAA - IRON SPARK I INC-A
ISBC - INVESTORS BANCORP INC
ISEE - IVERIC BIO INC
ISIG - INSIGNIA SYSTEMS INC
ISLE - ISLEWORTH HEALTHCARE ACQUISI
ISO - ISOPLEXIS CORP
ISPC - ISPECIMEN INC
ISRG - INTUITIVE SURGICAL INC
ISSC - INNOVATIVE SOLUTIONS & SUPP
ISTR - INVESTAR HOLDING CORP
ISUN - ISUN INC
IT - GARTNER INC
ITCI - INTRA-CELLULAR THERAPIES INC
ITGR - INTEGER HOLDINGS CORP
ITHX - ITHAX ACQUISITION CORP-A
ITI - ITERIS INC
ITIC - INVESTORS TITLE CO
ITOS - ITEOS THERAPEUTICS INC
ITQ - ITIQUIRA ACQUISITION CORP-A
ITRI - ITRON INC
ITRM - ITERUM THERAPEUTICS PLC
ITRN - ITURAN LOCATION AND CONTROL
ITT - ITT INC
ITW - ILLINOIS TOOL WORKS
IVAC - INTEVAC INC
IVAN - IVANHOE CAPITAL ACQUISIT-A
IVC - INVACARE CORP
IVZ - INVESCO LTD
IXAQ - IX ACQUISITION CORP-A
IZEA - IZEA WORLDWIDE INC
J - JACOBS ENGINEERING GROUP INC
JACK - JACK IN THE BOX INC
JAGX - JAGUAR HEALTH INC
JAKK - JAKKS PACIFIC INC
JAMF - JAMF HOLDING CORP
JAN - JANONE INC
JANX - JANUX THERAPEUTICS INC
JAQC - JUPITER ACQUISITION CORP-A
JATT - JATT ACQUISITION CORP - A
JAZZ - JAZZ PHARMACEUTICALS PLC
JBHT - HUNT (JB) TRANSPRT SVCS INC
JBI - JANUS INTERNATIONAL GROUP IN
JBL - JABIL INC
JBLU - JETBLUE AIRWAYS CORP
JBSS - JOHN B. SANFILIPPO & SON INC
JBT - JOHN BEAN TECHNOLOGIES CORP
JCI - JOHNSON CONTROLS INTERNATION
JCIC - JACK CREEK INVESTMENT C-CL A
JCS - COMMUNICATIONS SYSTEMS INC
JCTCF - JEWETT-CAMERON TRADING LTD
JEF - JEFFERIES FINANCIAL GROUP IN
JELD - JELD-WEN HOLDING INC
JHG - JANUS HENDERSON GROUP PLC
JILL - J. JILL INC
JJSF - J & J SNACK FOODS CORP
JKHY - JACK HENRY & ASSOCIATES INC
JLL - JONES LANG LASALLE INC
JMAC - MAXPRO CAPITAL ACQUISITION-A
JNCE - JOUNCE THERAPEUTICS INC
JNJ - JOHNSON & JOHNSON
JNPR - JUNIPER NETWORKS INC
JOAN - JOANN INC
JOBY - JOBY AVIATION INC
JOE - ST JOE CO/THE
JOFF - JOFF FINTECH ACQ CORP-A
JOUT - JOHNSON OUTDOORS INC-A
JPM - JPMORGAN CHASE & CO
JRSH - JERASH HOLDINGS US INC
JRVR - JAMES RIVER GROUP HOLDINGS L
JSPR - JASPER THERAPEUTICS INC
JUGG - JAWS JUGGERNAUT ACQUISITIO-A
JUPW - JUPITER WELLNESS INC
JVA - COFFEE HOLDING CO INC
JW.A - WILEY (JOHN) & SONS-CLASS A
JW.B - WILEY (JOHN) & SONS-CL B
JWEL - JOWELL GLOBAL LTD
JWN - NORDSTROM INC
JWSM - JAWS MUSTANG ACQUISITION C-A
JXN - JACKSON FINANCIAL INC-A
JYAC - JIYA ACQUISITION CORP -CL A
JYNT - JOINT CORP/THE
JZXN - JIUZI HOLDINGS INC
K - KELLOGG CO
KAHC - KKR ACQUISITION HOLDINGS I-A
KAI - KADANT INC
KAII - KISMET ACQUISITION TWO-CL A
KAIR - KAIROS ACQUISITION CORP-A
KALA - KALA PHARMACEUTICALS INC
KALU - KAISER ALUMINUM CORP
KALV - KALVISTA PHARMACEUTICALS INC
KAMN - KAMAN CORP
KAR - KAR AUCTION SERVICES INC
KARO - KAROOOOO LTD
KAVL - KAIVAL BRANDS INNOVATIONS GR
KBAL - KIMBALL INTERNATIONAL-B
KBH - KB HOME
KBNT - KUBIENT INC
KBR - KBR INC
KCGI - KENSINGTON CAPITAL ACQ-A
KD - KYNDRYL HOLDINGS INC
KDNY - CHINOOK THERAPEUTICS INC
KDP - KEURIG DR PEPPER INC
KE - KIMBALL ELECTRONICS INC
KELYA - KELLY SERVICES INC -A
KELYB - KELLY SERVICES INC -CL B
KEN - KENON HOLDINGS LTD
KEQU - KEWAUNEE SCIENTIFIC CP
KERN - AKERNA CORP
KEX - KIRBY CORP
KEY - KEYCORP
KEYS - KEYSIGHT TECHNOLOGIES IN
KFFB - KENTUCKY FIRST FEDERAL BANCO
KFRC - KFORCE INC
KFS - KINGSWAY FINANCIAL SERVICES
KFY - KORN FERRY
KGC - KINROSS GOLD CORP
KHC - KRAFT HEINZ CO/THE
KIDS - ORTHOPEDIATRICS CORP
KIII - KISMET ACQUISITION THREE - A
KIND - NEXTDOOR HOLDINGS INC
KINS - KINGSTONE COS INC
KINZ - KINS TECHNOLOGY GROUP INC-A
KIRK - KIRKLAND'S INC
KKR - KKR & CO INC
KL - KIRKLAND LAKE GOLD LTD
KLAC - KLA CORP
KLAQ - KL ACQUISITION CORP/MO-CLS A
KLDO - KALEIDO BIOSCIENCES INC
KLIC - KULICKE & SOFFA INDUSTRIES
KLR - KALEYRA INC
KLTR - KALTURA INC
KLXE - KLX ENERGY SERVICES HOLDING
KMB - KIMBERLY-CLARK CORP
KMDA - KAMADA LTD
KMI - KINDER MORGAN INC
KMPH - KEMPHARM INC
KMPR - KEMPER CORP
KMT - KENNAMETAL INC
KMX - CARMAX INC
KN - KNOWLES CORP
KNBE - KNOWBE4 INC-A
KNDI - KANDI TECHNOLOGIES GROUP INC
KNSA - KINIKSA PHARMACEUTICALS-A
KNSL - KINSALE CAPITAL GROUP INC
KNTE - KINNATE BIOPHARMA INC
KNX - KNIGHT-SWIFT TRANSPORTATION
KO - COCA-COLA CO/THE
KOD - KODIAK SCIENCES INC
KODK - EASTMAN KODAK CO
KOP - KOPPERS HOLDINGS INC
KOPN - KOPIN CORP
KOR - CORVUS GOLD INC
KORE - KORE GROUP HOLDINGS INC
KOS - KOSMOS ENERGY LTD
KOSS - KOSS CORP
KPLT - KATAPULT HOLDINGS INC
KPRX - KIORA PHARMACEUTICALS INC
KPTI - KARYOPHARM THERAPEUTICS INC
KR - KROGER CO
KRA - KRATON CORP
KRBP - KIROMIC BIOPHARMA INC
KRMD - REPRO MEDSYSTEMS INC
KRNL - KERNEL GROUP HOLDINGS INC-A
KRNT - KORNIT DIGITAL LTD
KRNY - KEARNY FINANCIAL CORP/MD
KRO - KRONOS WORLDWIDE INC
KRON - KRONOS BIO INC
KROS - KEROS THERAPEUTICS INC
KRT - KARAT PACKAGING INC
KRTX - KARUNA THERAPEUTICS INC
KRUS - KURA SUSHI USA INC-CLASS A
KRYS - KRYSTAL BIOTECH INC
KSI - KADEM SUSTAINABLE IMPAC-CL A
KSPN - KASPIEN HOLDINGS INC
KSS - KOHLS CORP
KTB - KONTOOR BRANDS INC
KTCC - KEY TRONIC CORP
KTOS - KRATOS DEFENSE & SECURITY
KTRA - KINTARA THERAPEUTICS INC
KTTA - PASITHEA THERAPEUTICS CORP
KURA - KURA ONCOLOGY INC
KVHI - KVH INDUSTRIES INC
KVSA - KHOSLA VENTURES ACQUISITION
KVSC - KHOSLA VENTURES ACQUISITIO-A
KW - KENNEDY-WILSON HOLDINGS INC
KWAC - KINGSWOOD ACQUISITION CORP-A
KWR - QUAKER CHEMICAL CORPORATION
KXIN - KAIXIN AUTO HOLDINGS
KYMR - KYMERA THERAPEUTICS INC
KZR - KEZAR LIFE SCIENCES INC
L - LOEWS CORP
LAAA - LAKESHORE ACQUISITION I CO-A
LABP - LANDOS BIOPHARMA INC
LAC - LITHIUM AMERICAS CORP
LAD - LITHIA MOTORS INC
LAKE - LAKELAND INDUSTRIES INC
LANC - LANCASTER COLONY CORP
LARK - LANDMARK BANCORP INC
LASR - NLIGHT INC
LAUR - LAUREATE EDUCATION INC-A
LAW - CS DISCO INC
LAWS - LAWSON PRODUCTS INC
LAX - 8I ACQUISITION 2 CORP
LAZ - LAZARD LTD-CL A
LAZR - LUMINAR TECHNOLOGIES INC
LAZY - LAZYDAYS HOLDINGS INC
LBAI - LAKELAND BANCORP INC
LBC - LUTHER BURBANK CORP
LBPH - LONGBOARD PHARMACEUTICALS IN
LBRDA - LIBERTY BROADBAND-A
LBRDK - LIBERTY BROADBAND-C
LBRT - LIBERTY OILFIELD SERVICES -A
LBTYA - LIBERTY GLOBAL PLC-A
LBTYB - LIBERTY GLOBAL PLC-B
LBTYK - LIBERTY GLOBAL PLC- C
LC - LENDINGCLUB CORP
LCA - LANDCADIA HOLDINGS IV INC-A
LCAA - L CATTERTON ASIA ACQ-CLASS A
LCAP - LIONHEART ACQUISITION CORP-A
LCI - LANNETT CO INC
LCID - LUCID GROUP INC
LCII - LCI INDUSTRIES
LCNB - LCNB CORPORATION
LCUT - LIFETIME BRANDS INC
LCW - LEARN CW INVESTMENT CORP-A
LDHA - LDH GROWTH CORP I-CLASS A
LDI - LOANDEPOT INC -CLASS A
LDOS - LEIDOS HOLDINGS INC
LE - LANDS' END INC
LEA - LEAR CORP
LEAP - RIBBIT LEAP LTD - CLASS A
LECO - LINCOLN ELECTRIC HOLDINGS
LEDS - SEMILEDS CORP/TW
LEE - LEE ENTERPRISES
LEG - LEGGETT & PLATT INC
LEGA - LEAD EDGE GROWTH OPPORTUNI-A
LEGH - LEGACY HOUSING CORP
LEN - LENNAR CORP-A
LEN.B - LENNAR CORP - B SHS
LESL - LESLIE'S INC
LEV - LION ELECTRIC CO/THE
LEVI - LEVI STRAUSS & CO- CLASS A
LEVL - LEVEL ONE BANCORP INC
LEXX - LEXARIA BIOSCIENCE CORP
LFG - ARCHAEA ENERGY INC
LFMD - LIFEMD INC
LFST - LIFESTANCE HEALTH GROUP INC
LFTR - LEFTERIS ACQUISITION CORP -A
LFUS - LITTELFUSE INC
LFVN - LIFEVANTAGE CORP
LGAC - LAZARD GROWTH ACQUISITION CO
LGF.A - LIONS GATE ENTERTAINMENT-A
LGF.B - LIONS GATE ENTERTAINMENT-B
LGIH - LGI HOMES INC
LGND - LIGAND PHARMACEUTICALS
LGO - LARGO INC
LGTO - LEGATO MERGER CORP II
LGV - LONGVIEW ACQUISITION CORP -A
LGVN - LONGEVERON INC
LH - LABORATORY CRP OF AMER HLDGS
LHAA - LERER HIPPEAU ACQUISITION-A
LHC - LEO HOLDINGS CORP II-CLASS A
LHCG - LHC GROUP INC
LHDX - LUCIRA HEALTH INC
LHX - L3HARRIS TECHNOLOGIES INC
LICY - LI-CYCLE HOLDINGS CORP
LIDR - AEYE INC
LIFE - ATYR PHARMA INC
LII - LENNOX INTERNATIONAL INC
LILA - LIBERTY LATIN AMERIC-CL A
LILAK - LIBERTY LATIN AMERIC-CL C
LILM - LILIUM NV
LIN - LINDE PLC
LINC - LINCOLN EDUCATIONAL SERVICES
LIND - LINDBLAD EXPEDITIONS HOLDING
LINK - INTERLINK ELECTRONICS INC
LION - LIONHEART III CORP -CLASS A
LIQT - LIQTECH INTERNATIONAL INC
LITE - LUMENTUM HOLDINGS INC
LITM - SNOW LAKE RESOURCES LTD
LITT - LOGISTICS INNOVATION TECH-A
LIVE - LIVE VENTURES INC
LIVN - LIVANOVA PLC
LIXT - LIXTE BIOTECHNOLOGY HOLDINGS
LJAQ - LIGHTJUMP ACQUISITION CORP
LJPC - LA JOLLA PHARMACEUTICAL CO
LKCO - LUOKUNG TECHNOLOGY CORP
LKFN - LAKELAND FINANCIAL CORP
LKQ - LKQ CORP
LL - LUMBER LIQUIDATORS HOLDINGS
LLL - JX LUXVENTURE LTD
LLNW - LIMELIGHT NETWORKS INC
LLY - ELI LILLY & CO
LMACA - LIBERTY MEDIA ACQUISITION -A
LMAO - LMF ACQUISITION OPPORTUNIT-A
LMAT - LEMAITRE VASCULAR INC
LMB - LIMBACH HOLDINGS INC
LMDX - LUMIRADX LTD
LMFA - LM FUNDING AMERICA INC
LMND - LEMONADE INC
LMNL - LIMINAL BIOSCIENCES INC
LMNR - LIMONEIRA CO
LMPX - LMP AUTOMOTIVE HOLDINGS INC
LMST - LIMESTONE BANCORP INC
LMT - LOCKHEED MARTIN CORP
LNC - LINCOLN NATIONAL CORP
LNDC - LANDEC CORP
LNFA - L&F ACQUISITION CORP/IL -A
LNN - LINDSAY CORP
LNSR - LENSAR INC
LNT - ALLIANT ENERGY CORP
LNTH - LANTHEUS HOLDINGS INC
LOB - LIVE OAK BANCSHARES INC
LOCC - LIVE OAK CRESTVIEW CLIMATE-A
LOCL - LOCAL BOUNTI CORP
LOCO - EL POLLO LOCO HOLDINGS INC
LOGC - LOGICBIO THERAPEUTICS INC
LOGI - LOGITECH INTERNATIONAL-REG
LOKM - LIVE OAK MOBILITY ACQUISIT-A
LOOP - LOOP INDUSTRIES INC
LOPE - GRAND CANYON EDUCATION INC
LOTZ - CARLOTZ INC
LOVE - LOVESAC CO/THE
LOW - LOWE'S COS INC
LPCN - LIPOCINE INC
LPG - DORIAN LPG LTD
LPI - LAREDO PETROLEUM INC
LPLA - LPL FINANCIAL HOLDINGS INC
LPRO - OPEN LENDING CORP -  CL A
LPSN - LIVEPERSON INC
LPTH - LIGHTPATH TECHNOLOGIES INC-A
LPTX - LEAP THERAPEUTICS INC
LPX - LOUISIANA-PACIFIC CORP
LQDA - LIQUIDIA CORP
LQDT - LIQUIDITY SERVICES INC
LRCX - LAM RESEARCH CORP
LRFC - LOGAN RIDGE FINANCE CORP
LRMR - LARIMAR THERAPEUTICS INC
LRN - STRIDE INC
LSBK - LAKE SHORE BANCORP INC
LSCC - LATTICE SEMICONDUCTOR CORP
LSEA - LANDSEA HOMES CORP
LSPD - LIGHTSPEED COMMERCE INC
LSTR - LANDSTAR SYSTEM INC
LTBR - LIGHTBRIDGE CORP
LTCH - LATCH INC
LTH - LIFE TIME GROUP HOLDINGS INC
LTHM - LIVENT CORP
LTRN - LANTERN PHARMA INC
LTRPA - LIBERTY TRIPADVISOR HDG-A
LTRPB - LIBERTY TRIPADVISOR HDG-B
LTRX - LANTRONIX INC
LTRY - LOTTERY.COM INC
LUB - LUBY'S INC
LUCD - LUCID DIAGNOSTICS INC
LULU - LULULEMON ATHLETICA INC
LUMN - LUMEN TECHNOLOGIES INC
LUMO - LUMOS PHARMA INC
LUNA - LUNA INNOVATIONS INC
LUNG - PULMONX CORP
LUV - SOUTHWEST AIRLINES CO
LUXA - LUX HEALTH TECH ACQUIS-CL A
LVAC - LAVA MEDTECH ACQUISITION C-A
LVLU - LULU'S FASHION LOUNGE HOLDIN
LVO - LIVEONE INC
LVOX - LIVEVOX HOLDINGS INC
LVRA - LEVERE HOLDINGS CORP-A
LVS - LAS VEGAS SANDS CORP
LVTX - LAVA THERAPEUTICS NV
LW - LAMB WESTON HOLDINGS INC
LWAY - LIFEWAY FOODS INC
LWLG - LIGHTWAVE LOGIC INC
LXFR - LUXFER HOLDINGS PLC
LXRX - LEXICON PHARMACEUTICALS INC
LXU - LSB INDUSTRIES INC
LYB - LYONDELLBASELL INDU-CL A
LYEL - LYELL IMMUNOPHARMA INC
LYFT - LYFT INC-A
LYL - DRAGON VICTORY INTERNATIONAL
LYLT - LOYALTY VENTURES INC
LYRA - LYRA THERAPEUTICS INC
LYTS - LSI INDUSTRIES INC
LYV - LIVE NATION ENTERTAINMENT IN
LZ - LEGALZOOMCOM INC
LZB - LA-Z-BOY INC
M - MACY'S INC
MA - MASTERCARD INC - A
MACA - MORINGA ACQUISITION CORP -A
MACC - MISSION ADVANCEMENT CORP-A
MACK - MERRIMACK PHARMACEUTICALS IN
MACQ - MCAP ACQUISITION CORP-A
MACU - MALLARD ACQUISITION CORP
MAIN - MAIN STREET CAPITAL CORP
MAN - MANPOWERGROUP INC
MANH - MANHATTAN ASSOCIATES INC
MANT - MANTECH INTERNATIONAL CORP-A
MANU - MANCHESTER UNITED PLC-CL A
MAPS - WM TECHNOLOGY INC
MAQC - MAQUIA CAPITAL ACQUISITION-A
MAR - MARRIOTT INTERNATIONAL -CL A
MARA - MARATHON DIGITAL HOLDINGS IN
MARK - REMARK HOLDINGS INC
MAS - MASCO CORP
MASI - MASIMO CORP
MASS - 908 DEVICES INC
MAT - MATTEL INC
MATW - MATTHEWS INTL CORP-CLASS A
MATX - MATSON INC
MAX - MEDIAALPHA INC-CLASS A
MAXN - MAXEON SOLAR TECHNOLOGIE
MAXR - MAXAR TECHNOLOGIES INC
MAYS - MAYS (J.W.) INC
MBAC - M3-BRIGADE ACQUISITION II-A
MBCN - MIDDLEFIELD BANC CORP
MBI - MBIA INC
MBII - MARRONE BIO INNOVATIONS INC
MBIN - MERCHANTS BANCORP/IN
MBIO - MUSTANG BIO INC
MBOT - MICROBOT MEDICAL INC
MBRX - MOLECULIN BIOTECH INC
MBSC - M3-BRIGADE ACQUISITION -CL A
MBTC - NOCTURNE ACQUISITION CORP
MBUU - MALIBU BOATS INC - A
MBWM - MERCANTILE BANK CORP
MC - MOELIS & CO - CLASS A
MCAE - MOUNTAIN CREST ACQUISITION C
MCAF - MOUNTAIN CREST ACQ CORP IV
MCAG - MOUNTAIN CREST ACQUISITION
MCB - METROPOLITAN BANK HOLDING CO
MCBC - MACATAWA BANK CORP
MCBS - METROCITY BANKSHARES INC
MCD - MCDONALD'S CORP
MCFE - MCAFEE CORP - CLASS A
MCFT - MASTERCRAFT BOAT HOLDINGS IN
MCG - MEMBERSHIP COLLECTIVE GRP -A
MCHP - MICROCHIP TECHNOLOGY INC
MCHX - MARCHEX INC-CLASS B
MCK - MCKESSON CORP
MCLD - MCLOUD TECHNOLOGIES CORP
MCMJ - MERIDA MERGER CORP I
MCO - MOODY'S CORP
MCRB - SERES THERAPEUTICS INC
MCRI - MONARCH CASINO & RESORT INC
MCS - MARCUS CORPORATION
MCW - MISTER CAR WASH INC
MCY - MERCURY GENERAL CORP
MD - MEDNAX INC
MDB - MONGODB INC
MDC - MDC HOLDINGS INC
MDGL - MADRIGAL PHARMACEUTICALS INC
MDH - MDH ACQUISITION CORP -CL A
MDIA - MEDIACO HOLDING INC-CL A-WI
MDJH - MDJM LTD
MDLZ - MONDELEZ INTERNATIONAL INC-A
MDNA - MEDICENNA THERAPEUTICS CORP
MDRX - ALLSCRIPTS HEALTHCARE SOLUTI
MDT - MEDTRONIC PLC
MDU - MDU RESOURCES GROUP INC
MDVL - MEDAVAIL HOLDINGS INC
MDWD - MEDIWOUND LTD
MDWT - MIDWEST HOLDING INC
MDXG - MIMEDX GROUP INC
ME - 23ANDME HOLDING CO -CLASS A
MEAC - MERCURY ECOMMERCE ACQUISIT-A
MEC - MAYVILLE ENGINEERING CO INC
MED - MEDIFAST INC
MEDP - MEDPACE HOLDINGS INC
MEDS - TRXADE HEALTH INC
MEG - MONTROSE ENVIRONMENTAL GROUP
MEI - METHODE ELECTRONICS INC
MEIP - MEI PHARMA INC
MEKA - MELI KASZEK PIONEER CORP-A
MELI - MERCADOLIBRE INC
MEOA - MINORITY EQUALITY OPPORTUN-A
MEOH - METHANEX CORP
MERC - MERCER INTERNATIONAL INC
MESA - MESA AIR GROUP INC
MET - METLIFE INC
METC - RAMACO RESOURCES INC
METX - METEN HOLDING GROUP LTD
MFC - MANULIFE FINANCIAL CORP
MFIN - MEDALLION FINANCIAL CORP
MG - MISTRAS GROUP INC
MGA - MAGNA INTERNATIONAL INC
MGEE - MGE ENERGY INC
MGI - MONEYGRAM INTERNATIONAL INC
MGIC - MAGIC SOFTWARE ENTERPRISES
MGLN - MAGELLAN HEALTH INC
MGM - MGM RESORTS INTERNATIONAL
MGNI - MAGNITE INC
MGNX - MACROGENICS INC
MGPI - MGP INGREDIENTS INC
MGRC - MCGRATH RENTCORP
MGTA - MAGENTA THERAPEUTICS INC
MGTX - MEIRAGTX HOLDINGS PLC
MGY - MAGNOLIA OIL & GAS CORP - A
MGYR - MAGYAR BANCORP INC
MHK - MOHAWK INDUSTRIES INC
MHLD - MAIDEN HOLDINGS LTD
MHO - M/I HOMES INC
MIC - MACQUARIE INFRASTRUCTURE HOL
MICT - MICT INC
MIDD - MIDDLEBY CORP
MIGI - MAWSON INFRASTRUCTURE GROUP
MILE - METROMILE INC
MIME - MIMECAST LTD
MIND - MIND TECHNOLOGY INC
MINM - MINIM INC
MIR - MIRION TECHNOLOGIES INC
MIRM - MIRUM PHARMACEUTICALS INC
MIRO - MIROMATRIX MEDICAL INC
MIST - MILESTONE PHARMACEUTICALS IN
MIT - MASON INDUSTRIAL TECHN-CL A
MITA - COLISEUM ACQUISITION CORP-A
MITK - MITEK SYSTEMS INC
MKC - MCCORMICK & CO-NON VTG SHRS
MKC.V - MCCORMICK & CO INC VTG COM
MKFG - MARKFORGED HOLDING CORP
MKL - MARKEL CORP
MKSI - MKS INSTRUMENTS INC
MKTW - MARKETWISE INC
MKTX - MARKETAXESS HOLDINGS INC
ML - MONEYLION INC
MLAB - MESA LABORATORIES INC
MLAC - MALACCA STRAITS ACQUISI-CL A
MLI - MUELLER INDUSTRIES INC
MLKN - MILLERKNOLL INC
MLM - MARTIN MARIETTA MATERIALS
MLNK - MERIDIANLINK INC
MLP - MAUI LAND & PINEAPPLE CO
MLR - MILLER INDUSTRIES INC/TENN
MLVF - MALVERN BANCORP INC
MMAT - META MATERIALS INC
MMC - MARSH & MCLENNAN COS
MMI - MARCUS & MILLICHAP INC
MMM - 3M CO
MMMB - MAMAMANCINI'S HOLDINGS INC
MMS - MAXIMUS INC
MMSI - MERIT MEDICAL SYSTEMS INC
MMYT - MAKEMYTRIP LTD
MN - MANNING & NAPIER INC
MNDO - MIND CTI LTD
MNDT - MANDIANT INC
MNDY - MONDAY.COM LTD
MNKD - MANNKIND CORP
MNMD - MIND MEDICINE MINDMED INC
MNOV - MEDICINOVA INC
MNPR - MONOPAR THERAPEUTICS INC
MNRL - BRIGHAM MINERALS INC-CL A
MNRO - MONRO INC
MNSB - MAINSTREET BANCSHARES INC
MNST - MONSTER BEVERAGE CORP
MNTK - MONTAUK RENEWABLES INC
MNTS - MOMENTUS INC
MNTV - MOMENTIVE GLOBAL INC
MNTX - MANITEX INTERNATIONAL INC
MO - ALTRIA GROUP INC
MOBQ - MOBIQUITY TECHNOLOGIES INC
MOD - MODINE MANUFACTURING CO
MODN - MODEL N INC
MODV - MODIVCARE INC
MOFG - MIDWESTONE FINANCIAL GROUP I
MOG.A - MOOG INC-CLASS A
MOG.B - MOOG INC-CLASS B
MOGO - MOGO INC
MOH - MOLINA HEALTHCARE INC
MON - MONUMENT CIRCLE ACQUI-CL A
MORF - MORPHIC HOLDING INC
MORN - MORNINGSTAR INC
MOS - MOSAIC CO/THE
MOTS - MOTUS GI HOLDINGS INC
MOTV - MOTIVE CAPITAL CORP -CL A
MOV - MOVADO GROUP INC
MOVE - MOVANO INC
MOXC - MOXIAN BVI INC
MP - MP MATERIALS CORP
MPAA - MOTORCAR PARTS OF AMERICA IN
MPAC - MODEL PERFORMANCE ACQUISIT-A
MPB - MID PENN BANCORP INC
MPC - MARATHON PETROLEUM CORP
MPLN - MULTIPLAN CORP
MPWR - MONOLITHIC POWER SYSTEMS INC
MPX - MARINE PRODUCTS CORP
MQ - MARQETA INC-A
MRAI - MARPAI INC-CLASS A
MRAM - EVERSPIN TECHNOLOGIES INC
MRBK - MERIDIAN CORP
MRC - MRC GLOBAL INC
MRCC - MONROE CAPITAL CORP
MRCY - MERCURY SYSTEMS INC
MRIN - MARIN SOFTWARE INC
MRK - MERCK & CO. INC.
MRKR - MARKER THERAPEUTICS INC
MRLN - MARLIN BUSINESS SERVICES INC
MRNA - MODERNA INC
MRNS - MARINUS PHARMACEUTICALS INC
MRO - MARATHON OIL CORP
MRSN - MERSANA THERAPEUTICS INC
MRTN - MARTEN TRANSPORT LTD
MRTX - MIRATI THERAPEUTICS INC
MRUS - MERUS NV
MRVI - MARAVAI LIFESCIENCES HLDGS-A
MRVL - MARVELL TECHNOLOGY INC
MS - MORGAN STANLEY
MSA - MSA SAFETY INC
MSAC - MEDICUS SCIENCES ACQUISITI-A
MSBI - MIDLAND STATES BANCORP INC
MSCI - MSCI INC
MSDA - MSD ACQUISITION CORP-A
MSEX - MIDDLESEX WATER CO
MSFT - MICROSOFT CORP
MSGE - MADISON SQUARE GARDEN ENTERT
MSGM - MOTORSPORT GAMES INC-A
MSGS - MADISON SQUARE GARDEN SPORTS
MSI - MOTOROLA SOLUTIONS INC
MSM - MSC INDUSTRIAL DIRECT CO-A
MSP - DATTO HOLDING CORP
MSTR - MICROSTRATEGY INC-CL A
MSVB - MID-SOUTHERN BANCORP INC
MTAC - MEDTECH ACQUISITION CORP-A
MTAL - METALS ACQUISITION CORP-CL A
MTB - M & T BANK CORP
MTBC - CARECLOUD INC
MTC - MMTEC INC
MTCH - MATCH GROUP INC
MTCR - METACRINE INC
MTD - METTLER-TOLEDO INTERNATIONAL
MTDR - MATADOR RESOURCES CO
MTEM - MOLECULAR TEMPLATES INC
MTEX - MANNATECH INC
MTG - MGIC INVESTMENT CORP
MTH - MERITAGE HOMES CORP
MTN - VAIL RESORTS INC
MTOR - MERITOR INC
MTRN - MATERION CORP
MTRX - MATRIX SERVICE CO
MTRY - MONTEREY BIO ACQUISITION COR
MTSI - MACOM TECHNOLOGY SOLUTIONS H
MTTR - MATTERPORT INC
MTW - MANITOWOC COMPANY INC
MTX - MINERALS TECHNOLOGIES INC
MTZ - MASTEC INC
MU - MICRON TECHNOLOGY INC
MUDS - MUDRICK CAPITAL ACQUISITIO-A
MULN - MULLEN AUTOMOTIVE INC
MUR - MURPHY OIL CORP
MUSA - MURPHY USA INC
MUX - MCEWEN MINING INC
MVBF - MVB FINANCIAL CORP
MVIS - MICROVISION INC
MVST - MICROVAST HOLDINGS INC
MWA - MUELLER WATER PRODUCTS INC-A
MX - MAGNACHIP SEMICONDUCTOR CORP
MXCT - MAXCYTE INC
MXL - MAXLINEAR INC
MYE - MYERS INDUSTRIES INC
MYFW - FIRST WESTERN FINANCIAL INC
MYGN - MYRIAD GENETICS INC
MYMD - MYMD PHARMACEUTICALS INC
MYNZ - MAINZ BIOMED BV
MYOV - MYOVANT SCIENCES LTD
MYPS - PLAYSTUDIOS INC
MYRG - MYR GROUP INC/DELAWARE
MYSZ - MY SIZE INC
NAAC - NORTH ATLANTIC ACQUISITION-A
NABL - N-ABLE INC
NAII - NATURAL ALTERNATIVES INTL
NAKD - NAKED BRAND GROUP LTD
NAOV - NANOVIBRONIX INC
NAPA - DUCKHORN PORTFOLIO INC/THE
NARI - INARI MEDICAL INC
NAT - NORDIC AMERICAN TANKERS LTD
NATH - NATHAN'S FAMOUS INC
NATI - NATIONAL INSTRUMENTS CORP
NATR - NATURES SUNSHINE PRODS INC
NAUT - NAUTILUS BIOTECHNOLOGY INC
NAVI - NAVIENT CORP
NBEV - NEWAGE INC
NBHC - NATIONAL BANK HOLD-CL A
NBIX - NEUROCRINE BIOSCIENCES INC
NBN - NORTHEAST BANK
NBR - NABORS INDUSTRIES LTD
NBRV - NABRIVA THERAPEUTICS PLC
NBSE - NEUBASE THERAPEUTICS INC
NBST - NEWBURY STREET ACQUISITION C
NBTB - N B T BANCORP INC
NC - NACCO INDUSTRIES-CL A
NCAC - NEWCOURT ACQUISITION CORP-A
NCBS - NICOLET BANKSHARES INC
NCLH - NORWEGIAN CRUISE LINE HOLDIN
NCMI - NATIONAL CINEMEDIA INC
NCNO - NCINO INC
NCR - NCR CORPORATION
NCSM - NCS MULTISTAGE HOLDINGS INC
NDAC - NIGHTDRAGON ACQUISITION CO-A
NDAQ - NASDAQ INC
NDLS - NOODLES & CO
NDRA - ENDRA LIFE SCIENCES INC
NDSN - NORDSON CORP
NE - NOBLE CORP
NECB - NORTHEAST COMMUNITY BANCORP
NEE - NEXTERA ENERGY INC
NEGG - NEWEGG COMMERCE INC
NEM - NEWMONT CORP
NEO - NEOGENOMICS INC
NEOG - NEOGEN CORP
NEON - NEONODE INC
NEP - NEXTERA ENERGY PARTNERS LP
NEPH - NEPHROS INC
NEPT - NEPTUNE WELLNESS SOLUTIONS I
NERV - MINERVA NEUROSCIENCES INC
NESR - NATIONAL ENERGY SERVICES REU
NET - CLOUDFLARE INC - CLASS A
NETI - ENETI INC
NEU - NEWMARKET CORP
NEWR - NEW RELIC INC
NEWT - NEWTEK BUSINESS SERVICES COR
NEX - NEXTIER OILFIELD SOLUTIONS I
NEXA - NEXA RESOURCES SA
NEXI - NEXIMMUNE INC
NEXT - NEXTDECADE CORP
NFBK - NORTHFIELD BANCORP INC
NFE - NEW FORTRESS ENERGY INC
NFG - NATIONAL FUEL GAS CO
NFH - NEW FRONTIER HEALTH CORP
NFLX - NETFLIX INC
NFYS - ENPHYS ACQUISITION CORP
NGC - NORTHERN GENESIS ACQUISITI-A
NGCA - NEXTGEN ACQUISITION CORP-A
NGM - NGM BIOPHARMACEUTICALS INC
NGMS - NEOGAMES SA
NGS - NATURAL GAS SERVICES GROUP
NGVC - NATURAL GROCERS BY VITAMIN C
NGVT - INGEVITY CORP
NH - NANTHEALTH INC
NHIC - NEWHOLD INVESTMENT CORP II-A
NHTC - NATURAL HEALTH TRENDS CORP
NI - NISOURCE INC
NICK - NICHOLAS FINANCIAL INC
NINE - NINE ENERGY SERVICE INC
NISN - NISUN INTERNATIONAL ENTERPRI
NJR - NEW JERSEY RESOURCES CORP
NKE - NIKE INC -CL B
NKLA - NIKOLA CORP
NKSH - NATIONAL BANKSHARES INC/VA
NKTR - NEKTAR THERAPEUTICS
NKTX - NKARTA INC
NL - NL INDUSTRIES
NLIT - NORTHERN LIGHTS ACQUISITI-A
NLOK - NORTONLIFELOCK INC
NLS - NAUTILUS INC
NLSN - NIELSEN HOLDINGS PLC
NLSP - NLS PHARMACEUTICS LTD
NLTX - NEOLEUKIN THERAPEUTICS INC
NM - NAVIOS MARITIME HOLDINGS INC
NMFC - NEW MOUNTAIN FINANCE CORP
NMG - NOUVEAU MONDE GRAPHITE INC
NMIH - NMI HOLDINGS INC-CLASS A
NMMC - NORTH MOUNTAIN MERGER CORP-A
NMRD - NEMAURA MEDICAL INC
NMRK - NEWMARK GROUP INC-CLASS A
NMTC - NEUROONE MEDICAL TECHNOLOGIE
NMTR - 9 METERS BIOPHARMA INC
NN - NEXTNAV INC
NNBR - NN INC
NNI - NELNET INC-CL A
NNOX - NANO-X IMAGING LTD
NOA - NORTH AMERICAN CONSTRUCTION
NOAC - NATURAL ORDER ACQUISITION CO
NOC - NORTHROP GRUMMAN CORP
NODK - NI HOLDINGS INC
NOMD - NOMAD FOODS LTD
NOTV - INOTIV INC
NOV - NOV INC
NOVA - SUNNOVA ENERGY INTERNATIONAL
NOVN - NOVAN INC
NOVT - NOVANTA INC
NOVV - NOVA VISION ACQUISITION
NOW - SERVICENOW INC
NP - NEENAH INC
NPCE - NEUROPACE INC
NPK - NATIONAL PRESTO INDS INC
NPO - ENPRO INDUSTRIES INC
NPTN - NEOPHOTONICS CORP
NR - NEWPARK RESOURCES INC
NRAC - NOBLE ROCK ACQUISITION COR-A
NRBO - NEUROBO PHARMACEUTICALS INC
NRC - NATIONAL RESEARCH CORP
NRDS - NERDWALLET INC-CL A
NRDY - NERDY INC
NRG - NRG ENERGY INC
NRIM - NORTHRIM BANCORP INC
NRIX - NURIX THERAPEUTICS INC
NRSN - NEUROSENSE THERAPEUTICS LTD
NRXP - NRX PHARMACEUTICALS INC
NSC - NORFOLK SOUTHERN CORP
NSEC - NATIONAL SECURITY GROUP INC
NSIT - INSIGHT ENTERPRISES INC
NSP - INSPERITY INC
NSPR - INSPIREMD INC
NSR - NOMAD ROYALTY CO LTD
NSSC - NAPCO SECURITY TECHNOLOGIES
NSTB - NORTHERN STAR INVESTMENT C-A
NSTC - NORTHERN STAR INVESTMENT -A
NSTD - NORTHERN STAR INVESTMENT -A
NSTG - NANOSTRING TECHNOLOGIES INC
NSYS - NORTECH SYSTEMS INC
NTAP - NETAPP INC
NTB - BANK OF N.T. BUTTERFIELD&SON
NTCT - NETSCOUT SYSTEMS INC
NTGR - NETGEAR INC
NTIC - NORTHERN TECHNOLOGIES INTL
NTLA - INTELLIA THERAPEUTICS INC
NTNX - NUTANIX INC - A
NTP - NAM TAI PROPERTY INC
NTR - NUTRIEN LTD
NTRA - NATERA INC
NTRB - NUTRIBAND INC
NTRS - NORTHERN TRUST CORP
NTUS - NATUS MEDICAL INC
NTWK - NETSOL TECHNOLOGIES INC
NU - NU HOLDINGS LTD/CAYMAN ISL-A
NUAN - NUANCE COMMUNICATIONS INC
NUE - NUCOR CORP
NURO - NEUROMETRIX INC
NUS - NU SKIN ENTERPRISES INC - A
NUVA - NUVASIVE INC
NUVB - NUVATION BIO INC
NUVL - NUVALENT INC-A
NUWE - NUWELLIS INC
NUZE - NUZEE INC
NVAX - NOVAVAX INC
NVCN - NEOVASC INC
NVCR - NOVOCURE LTD
NVDA - NVIDIA CORP
NVEC - NVE CORP
NVEE - NV5 GLOBAL INC
NVEI - NUVEI CORP-SUBORDINATE VTG
NVFY - NOVA LIFESTYLE INC
NVGS - NAVIGATOR HOLDINGS LTD
NVIV - INVIVO THERAPEUTICS HOLDINGS
NVMI - NOVA LTD
NVNO - ENVVENO MEDICAL CORP
NVOS - NOVO INTEGRATED SCIENCES INC
NVR - NVR INC
NVRO - NEVRO CORP
NVSA - NEW VISTA ACQUISITION CORP-A
NVST - ENVISTA HOLDINGS CORP
NVT - NVENT ELECTRIC PLC
NVTA - INVITAE CORP
NVTS - NAVITAS SEMICONDUCTOR CORP
NVVE - NUVVE HOLDING CORP
NWBI - NORTHWEST BANCSHARES INC
NWE - NORTHWESTERN CORP
NWFL - NORWOOD FINANCIAL CORP
NWL - NEWELL BRANDS INC
NWLI - NATIONAL WESTERN LIFE GROU-A
NWN - NORTHWEST NATURAL HOLDING CO
NWPX - NORTHWEST PIPE CO
NWS - NEWS CORP - CLASS B
NWSA - NEWS CORP - CLASS A
NX - QUANEX BUILDING PRODUCTS
NXGL - NEXGEL INC
NXGN - NEXTGEN HEALTHCARE INC
NXPI - NXP SEMICONDUCTORS NV
NXST - NEXSTAR MEDIA GROUP INC-CL A
NXTC - NEXTCURE INC
NXTD - NXT-ID INC
NXTP - NEXTPLAY TECHNOLOGIES INC
NXU - NOVUS CAPITAL CORP II-A
NYCB - NEW YORK COMMUNITY BANCORP
NYMX - NYMOX PHARMACEUTICAL CORP
NYT - NEW YORK TIMES CO-A
NYXH - NYXOAH SA
OACB - OAKTREE ACQ CORP II - CL A
OAS - OASIS PETROLEUM INC
OB - OUTBRAIN INC
OBAS - OPTIBASE LTD
OBCI - OCEAN BIO-CHEM INC
OBLG - OBLONG INC
OBNK - ORIGIN BANCORP INC
OBSV - OBSEVA SA
OBT - ORANGE COUNTY BANCORP INC
OC - OWENS CORNING
OCA - OMNICHANNEL ACQUISITION-CL A
OCAX - OCA ACQUISITION CORP-CL A
OCC - OPTICAL CABLE CORP
OCDX - ORTHO CLINICAL DIAGNOSTICS H
OCFC - OCEANFIRST FINANCIAL CORP
OCG - ORIENTAL CULTURE HOLDING LTD
OCGN - OCUGEN INC
OCN - OCWEN FINANCIAL CORP
OCSL - OAKTREE SPECIALTY LENDING CO
OCUL - OCULAR THERAPEUTIX INC
OCUP - OCUPHIRE PHARMA INC
OCX - ONCOCYTE CORP
ODC - OIL-DRI CORP OF AMERICA
ODFL - OLD DOMINION FREIGHT LINE
ODP - ODP CORP/THE
ODT - ODONATE THERAPEUTICS INC
OEC - ORION ENGINEERED CARBONS SA
OEG - ORBITAL ENERGY GROUP INC
OEPW - ONE EQUITY PARTNERS OPEN-A
OESX - ORION ENERGY SYSTEMS INC
OFED - OCONEE FEDERAL FINANCIAL COR
OFG - OFG BANCORP
OFIX - ORTHOFIX MEDICAL INC
OFLX - OMEGA FLEX INC
OFS - OFS CAPITAL CORP
OGE - OGE ENERGY CORP
OGI - ORGANIGRAM HOLDINGS INC
OGN - ORGANON & CO
OGS - ONE GAS INC
OHAA - OPY ACQUISITION CORP I - A
OHPA - ORION ACQUISITION CORP-CL A
OI - O-I GLASS INC
OII - OCEANEERING INTL INC
OIS - OIL STATES INTERNATIONAL INC
OKE - ONEOK INC
OKTA - OKTA INC
OLB - OLB GROUP INC
OLED - UNIVERSAL DISPLAY CORP
OLLI - OLLIE'S BARGAIN OUTLET HOLDI
OLMA - OLEMA PHARMACEUTICALS INC
OLN - OLIN CORP
OLO - OLO INC - CLASS A
OLPX - OLAPLEX HOLDINGS INC
OM - OUTSET MEDICAL INC
OMC - OMNICOM GROUP
OMCL - OMNICELL INC
OMEG - OMEGA ALPHA SPAC -CLASS A
OMER - OMEROS CORP
OMEX - ODYSSEY MARINE EXPLORATION
OMF - ONEMAIN HOLDINGS INC
OMGA - OMEGA THERAPEUTICS INC
OMI - OWENS & MINOR INC
OMIC - SINGULAR GENOMICS SYSTEMS IN
OMQS - OMNIQ CORP
ON - ON SEMICONDUCTOR
ONB - OLD NATIONAL BANCORP
ONCR - ONCORUS INC
ONCS - ONCOSEC MEDICAL INC
ONCT - ONCTERNAL THERAPEUTICS INC
ONCY - ONCOLYTICS BIOTECH INC
ONDS - ONDAS HOLDINGS INC
ONEM - 1LIFE HEALTHCARE INC
ONEW - ONEWATER MARINE INC-CL A
ONON - ON HOLDING AG-CLASS A
ONTF - ON24 INC
ONTO - ONTO INNOVATION INC
ONTX - ONCONOVA THERAPEUTICS INC
ONVO - ORGANOVO HOLDINGS INC
ONYX - ONYX ACQUISITION CO I-CL A
OOMA - OOMA INC
OP - OCEANPAL INC
OPA - MAGNUM OPUS ACQUISITION LT-A
OPAD - OFFERPAD SOLUTIONS INC
OPBK - OP BANCORP
OPCH - OPTION CARE HEALTH INC
OPEN - OPENDOOR TECHNOLOGIES INC
OPFI - OPPFI INC
OPGN - OPGEN INC
OPHC - OPTIMUMBANK HOLDINGS INC
OPK - OPKO HEALTH INC
OPNT - OPIANT PHARMACEUTICALS INC
OPOF - OLD POINT FINANCIAL CORP
OPRT - OPORTUN FINANCIAL CORP
OPRX - OPTIMIZERX CORP
OPTN - OPTINOSE INC
OPY - OPPENHEIMER HOLDINGS-CL A
OR - OSISKO GOLD ROYALTIES LTD
ORA - ORMAT TECHNOLOGIES INC
ORCC - OWL ROCK CAPITAL CORP
ORCL - ORACLE CORP
ORGN - ORIGIN MATERIALS INC
ORGO - ORGANOGENESIS HOLDINGS INC
ORGS - ORGENESIS INC
ORI - OLD REPUBLIC INTL CORP
ORIA - ORION BIOTECH OPPORTUNITI-A
ORIC - ORIC PHARMACEUTICALS INC
ORLY - O'REILLY AUTOMOTIVE INC
ORMP - ORAMED PHARMACEUTICALS INC
ORN - ORION GROUP HOLDINGS INC
ORRF - ORRSTOWN FINL SERVICES INC
OSAT - ORBSAT CORP
OSBC - OLD SECOND BANCORP INC
OSCR - OSCAR HEALTH INC - CLASS A
OSG - OVERSEAS SHIPHOLDING GROUP-A
OSH - OAK STREET HEALTH INC
OSI - OSIRIS ACQUISITION CORP-A
OSIS - OSI SYSTEMS INC
OSK - OSHKOSH CORP
OSMT - OSMOTICA PHARMACEUTICALS PLC
OSPN - ONESPAN INC
OSS - ONE STOP SYSTEMS INC
OSTK - OVERSTOCK.COM INC
OSTR - OYSTER ENTERPRISES-CL A
OSUR - ORASURE TECHNOLOGIES INC
OSW - ONESPAWORLD HOLDINGS LTD
OTEC - OCEANTECH ACQUISITIONS- CL A
OTEX - OPEN TEXT CORP
OTIC - OTONOMY INC
OTIS - OTIS WORLDWIDE CORP
OTLK - OUTLOOK THERAPEUTICS INC
OTMO - OTONOMO TECHNOLOGIES LTD
OTRA - OTR ACQUISITION CORP-CLASS A
OTRK - ONTRAK INC
OTTR - OTTER TAIL CORP
OUST - OUSTER INC
OVBC - OHIO VALLEY BANC CORP
OVID - OVID THERAPEUTICS INC
OVLY - OAK VALLEY BANCORP
OVV - OVINTIV INC
OWL - BLUE OWL CAPITAL INC
OWLT - OWLET INC
OXAC - OXBRIDGE ACQUISITION CORP
OXBR - OXBRIDGE RE HOLDINGS LTD
OXM - OXFORD INDUSTRIES INC
OXSQ - OXFORD SQUARE CAPITAL CORP
OXUS - OXUS ACQUISITION CORP-A
OXY - OCCIDENTAL PETROLEUM CORP
OYST - OYSTER POINT PHARMA INC
OZK - BANK OZK
PAAS - PAN AMERICAN SILVER CORP
PACB - PACIFIC BIOSCIENCES OF CALIF
PACK - RANPAK HOLDINGS CORP
PACW - PACWEST BANCORP
PACX - PIONEER MERGER CORP -CLASS A
PAE - PAE INC
PAFO - PACIFICO ACQUISTION CORP
PAG - PENSKE AUTOMOTIVE GROUP INC
PAGP - PLAINS GP HOLDINGS LP-CL A
PAGS - PAGSEGURO DIGITAL LTD-CL A
PAHC - PHIBRO ANIMAL HEALTH CORP-A
PAIC - PETRA ACQUISITION INC
PALI - PALISADE BIO INC
PALT - PALTALK INC
PANA - PANACEA ACQUISITION CORPII-A
PANL - PANGAEA LOGISTICS SOLUTIONS
PANW - PALO ALTO NETWORKS INC
PAQC - PROVIDENT ACQUISITION CORP-A
PAR - PAR TECHNOLOGY CORP/DEL
PARR - PAR PACIFIC HOLDINGS INC
PASG - PASSAGE BIO INC
PATH - UIPATH INC - CLASS A
PATI - PATRIOT TRANSPORTATION HOLDI
PATK - PATRICK INDUSTRIES INC
PAVM - PAVMED INC
PAX - PATRIA INVESTMENTS LTD-A
PAY - PAYMENTUS HOLDINGS INC-A
PAYA - PAYA HOLDINGS INC
PAYC - PAYCOM SOFTWARE INC
PAYO - PAYONEER GLOBAL INC
PAYS - PAYSIGN INC
PAYX - PAYCHEX INC
PB - PROSPERITY BANCSHARES INC
PBA - PEMBINA PIPELINE CORP
PBAX - PHOENIX BIOTECH ACQUISI-CL A
PBBK - PB BANKSHARES INC
PBCT - PEOPLE'S UNITED FINANCIAL
PBF - PBF ENERGY INC-CLASS A
PBFS - PIONEER BANCORP INC/NY
PBH - PRESTIGE CONSUMER HEALTHCARE
PBHC - PATHFINDER BANCORP INC
PBI - PITNEY BOWES INC
PBIP - PRUDENTIAL BANCORP INC
PBLA - PANBELA THERAPEUTICS INC
PBPB - POTBELLY CORP
PBTS - POWERBRIDGE TECHNOLOGIES CO
PBYI - PUMA BIOTECHNOLOGY INC
PCAR - PACCAR INC
PCB - PCB BANCORP
PCCT - PERCEPTION CAPITAL CORP II-A
PCG - P G & E CORP
PCOM - POINTS INTERNATIONAL LTD
PCOR - PROCORE TECHNOLOGIES INC
PCPC - PERIPHAS CAPITAL PARTNR-CL A
PCRX - PACIRA BIOSCIENCES INC
PCSA - PROCESSA PHARMACEUTICALS INC
PCSB - PCSB FINANCIAL CORP
PCT - PURECYCLE TECHNOLOGIES INC
PCTI - PCTEL INC
PCTY - PAYLOCITY HOLDING CORP
PCVX - VAXCYTE INC
PCX - PARSEC CAPITAL ACQUISITION-A
PCYG - PARK CITY GROUP INC
PCYO - PURE CYCLE CORP
PD - PAGERDUTY INC
PDCE - PDC ENERGY INC
PDCO - PATTERSON COS INC
PDEX - PRO-DEX INC
PDFS - PDF SOLUTIONS INC
PDLB - PDL COMMUNITY BANCORP
PDOT - PERIDOT ACQUISITION CORP-A
PDS - PRECISION DRILLING CORP
PDSB - PDS BIOTECHNOLOGY CORP
PEAR - PEAR THERAPEUTICS INC
PEBK - PEOPLES BANCORP OF NC
PEBO - PEOPLES BANCORP INC
PEG - PUBLIC SERVICE ENTERPRISE GP
PEGA - PEGASYSTEMS INC
PEGR - PROJECT ENERGY REIMAGINED AC
PEN - PENUMBRA INC
PENN - PENN NATIONAL GAMING INC
PEP - PEPSICO INC
PEPL - PEPPERLIME HEALTH ACQ - A
PERI - PERION NETWORK LTD
PESI - PERMA-FIX ENVIRONMENTAL SVCS
PETQ - PETIQ INC
PETS - PETMED EXPRESS INC
PETV - PETVIVO HOLDINGS INC
PETZ - TDH HOLDINGS INC
PFBC - PREFERRED BANK/LOS ANGELES
PFC - PREMIER FINANCIAL CORP
PFDR - PATHFINDER ACQUISITION -CL A
PFE - PFIZER INC
PFG - PRINCIPAL FINANCIAL GROUP
PFGC - PERFORMANCE FOOD GROUP CO
PFHD - PROFESSIONAL HOLDING CORP-A
PFIE - PROFIRE ENERGY INC
PFIN - P & F INDUSTRIES -CL A
PFIS - PEOPLES FINANCIAL SERVICES
PFLT - PENNANTPARK FLOATING RATE CA
PFMT - PERFORMANT FINANCIAL CORP
PFS - PROVIDENT FINANCIAL SERVICES
PFSI - PENNYMAC FINANCIAL SERVICES
PFSW - PFSWEB INC
PFTA - PORTAGE FINTECH ACQUISITIO-A
PFX - PHENIXFIN CORP
PG - PROCTER & GAMBLE CO/THE
PGC - PEAPACK GLADSTONE FINL CORP
PGEN - PRECIGEN INC
PGNY - PROGYNY INC
PGR - PROGRESSIVE CORP
PGRW - PROGRESS ACQUISITION CORP-A
PGSS - PEGASUS DIGITAL MOBILITY A-A
PGTI - PGT INNOVATIONS INC
PH - PARKER HANNIFIN CORP
PHAS - PHASEBIO PHARMACEUTICALS INC
PHAT - PHATHOM PHARMACEUTICALS INC
PHCF - PUHUI WEALTH INVESTMENT MANA
PHIC - POPULATION HEALTH INVEST-A
PHIO - PHIO PHARMACEUTICALS CORP
PHM - PULTEGROUP INC
PHR - PHREESIA INC
PHUN - PHUNWARE INC
PHVS - PHARVARIS NV
PHX - PHX MINERALS INC
PHYT - PYROPHYTE ACQUISITION CORP-A
PI - IMPINJ INC
PIAI - PRIME IMPACT ACQU I -CL A
PICC - PIVOTAL INVESTMENT CORPIII-A
PII - POLARIS INC
PIII - P3 HEALTH PARTNERS INC
PIK - KIDPIK CORP
PINC - PREMIER INC-CLASS A
PING - PING IDENTITY HOLDING CORP
PINS - PINTEREST INC- CLASS A
PIPP - PINE ISLAND ACQUISITION-CL A
PIPR - PIPER SANDLER COS
PIRS - PIERIS PHARMACEUTICALS INC
PIXY - SHIFTPIXY INC
PJT - PJT PARTNERS INC - A
PKBK - PARKE BANCORP INC
PKE - PARK AEROSPACE CORP
PKG - PACKAGING CORP OF AMERICA
PKI - PERKINELMER INC
PKOH - PARK-OHIO HOLDINGS CORP
PL - PLANET LABS PBC
PLAB - PHOTRONICS INC
PLAN - ANAPLAN INC
PLAY - DAVE & BUSTER'S ENTERTAINMEN
PLBC - PLUMAS BANCORP
PLBY - PLBY GROUP INC
PLCE - CHILDREN'S PLACE INC/THE
PLIN - CHINA XIANGTAI FOOD CO LTD
PLL - PIEDMONT LITHIUM INC
PLMI - PLUM ACQUISITION CORP I-A
PLMR - PALOMAR HOLDINGS INC
PLNT - PLANET FITNESS INC - CL A
PLOW - DOUGLAS DYNAMICS INC
PLPC - PREFORMED LINE PRODUCTS CO
PLRX - PLIANT THERAPEUTICS INC
PLSE - PULSE BIOSCIENCES INC
PLTK - PLAYTIKA HOLDING CORP
PLTR - PALANTIR TECHNOLOGIES INC-A
PLUG - PLUG POWER INC
PLUS - EPLUS INC
PLXP - PLX PHARMA INC
PLXS - PLEXUS CORP
PLYA - PLAYA HOTELS & RESORTS NV
PM - PHILIP MORRIS INTERNATIONAL
PMCB - PHARMACYTE BIOTECH INC
PMD - PSYCHEMEDICS CORP
PME - PINGTAN MARINE ENTERPRISE LT
PMGM - PRIVETERRA ACQUISITION COR-A
PMTS - CPI CARD GROUP INC
PMVC - PMV CONSUMER ACQUISITION-A
PMVP - PMV PHARMACEUTICALS INC
PNBK - PATRIOT NATIONAL BANCORP INC
PNC - PNC FINANCIAL SERVICES GROUP
PNFP - PINNACLE FINANCIAL PARTNERS
PNM - PNM RESOURCES INC
PNNT - PENNANTPARK INVESTMENT CORP
PNR - PENTAIR PLC
PNRG - PRIMEENERGY RESOURCES CORP
PNT - POINT BIOPHARMA GLOBAL INC
PNTG - PENNANT GROUP INC/THE
PNTM - PONTEM CORP-CLASS A
PNW - PINNACLE WEST CAPITAL
POAI - PREDICTIVE ONCOLOGY INC
PODD - INSULET CORP
POLA - POLAR POWER INC
POLY - PLANTRONICS INC
POND - ANGEL POND HOLDINGS CORP-A
PONO - PONO CAPITAL CORP-A
POOL - POOL CORP
POR - PORTLAND GENERAL ELECTRIC CO
POSH - POSHMARK INC-CLASS A
POST - POST HOLDINGS INC
POW - POWERED BRANDS - CLASS A
POWI - POWER INTEGRATIONS INC
POWL - POWELL INDUSTRIES INC
POWW - AMMO INC
PPBI - PACIFIC PREMIER BANCORP INC
PPC - PILGRIM'S PRIDE CORP
PPG - PPG INDUSTRIES INC
PPGH - POEMA GLOBAL HOLDINGS CORP-A
PPHP - PHP VENTURES ACQUISITION -A
PPIH - PERMA-PIPE INTERNATIONAL HOL
PPL - PPL CORP
PPSI - PIONEER POWER SOLUTIONS INC
PPTA - PERPETUA RESOURCES CORP
PRA - PROASSURANCE CORP
PRAA - PRA GROUP INC
PRAX - PRAXIS PRECISION MEDICINES I
PRBM - PARABELLUM ACQUISITION COR-A
PRCH - PORCH GROUP INC
PRCT - PROCEPT BIOROBOTICS CORP
PRDO - PERDOCEO EDUCATION CORP
PRFT - PERFICIENT INC
PRFX - PAINREFORM LTD
PRG - PROG HOLDINGS INC
PRGO - PERRIGO CO PLC
PRGS - PROGRESS SOFTWARE CORP
PRI - PRIMERICA INC
PRIM - PRIMORIS SERVICES CORP
PRLB - PROTO LABS INC
PRLD - PRELUDE THERAPEUTICS INC
PRM - PERIMETER SOLUTIONS SA
PRMW - PRIMO WATER CORP
PRO - PROS HOLDINGS INC
PROC - PROCAPS GROUP SA
PROF - PROFOUND MEDICAL CORP
PROG - PROGENITY INC
PROV - PROVIDENT FINANCIAL HLDGS
PRPB - CC NEUBERGER PRINCIPAL II-A
PRPC - CC NEUBERGER PRINCIPAL III-A
PRPH - PROPHASE LABS INC
PRPL - PURPLE INNOVATION INC
PRPO - PRECIPIO INC
PRQR - PROQR THERAPEUTICS NV
PRSO - PERASO INC
PRSR - PROSPECTOR CAPITAL CORP-CL A
PRTA - PROTHENA CORP PLC
PRTG - PORTAGE BIOTECH INC
PRTH - PRIORITY TECHNOLOGY HOLDINGS
PRTK - PARATEK PHARMACEUTICALS INC
PRTS - CARPARTS.COM INC
PRTY - PARTY CITY HOLDCO INC
PRU - PRUDENTIAL FINANCIAL INC
PRVA - PRIVIA HEALTH GROUP INC
PRVB - PROVENTION BIO INC
PSAG - PROPERTY SOLUTIONS ACQUISI-A
PSEC - PROSPECT CAPITAL CORP
PSFE - PAYSAFE LTD
PSHG - PERFORMANCE SHIPPING INC
PSMT - PRICESMART INC
PSN - PARSONS CORP
PSNL - PERSONALIS INC
PSPC - POST HOLDINGS PARTNERING -A
PSTG - PURE STORAGE INC - CLASS A
PSTH - PERSHING SQUARE TONTINE -A
PSTI - PLURISTEM THERAPEUTICS INC
PSTV - PLUS THERAPEUTICS INC
PSTX - POSEIDA THERAPEUTICS INC
PSX - PHILLIPS 66
PTC - PTC INC
PTCT - PTC THERAPEUTICS INC
PTE - POLARITYTE INC
PTEN - PATTERSON-UTI ENERGY INC
PTGX - PROTAGONIST THERAPEUTICS INC
PTIC - PROPTECH INVESTMENT CORP-A
PTIX - PROTAGENIC THERAPEUTICS INC
PTLO - PORTILLO'S INC-CL A
PTMN - PORTMAN RIDGE FINANCE CORP
PTOC - PINE TECHNOLOGY ACQUISI-CL A
PTON - PELOTON INTERACTIVE INC-A
PTPI - PETROS PHARMACEUTICALS INC
PTRA - PROTERRA INC
PTRS - PARTNERS BANCORP
PTSI - P.A.M. TRANSPORTATION SVCS
PTVE - PACTIV EVERGREEN INC
PUBM - PUBMATIC INC-CLASS A
PUCK - GOAL ACQUISITIONS CORP
PULM - PULMATRIX INC
PUMP - PROPETRO HOLDING CORP
PV - PRIMAVERA CAPITAL ACQUISIT-A
PVBC - PROVIDENT BANCORP INC
PVG - PRETIUM RESOURCES INC
PVH - PVH CORP
PWFL - POWERFLEET INC
PWOD - PENNS WOODS BANCORP INC
PWP - PERELLA WEINBERG PARTNERS
PWR - QUANTA SERVICES INC
PWSC - POWERSCHOOL HOLDINGS INC-A
PX - P10 INC-A
PXD - PIONEER NATURAL RESOURCES CO
PXLW - PIXELWORKS INC
PXS - PYXIS TANKERS INC
PYCR - PAYCOR HCM INC
PYPD - POLYPID LTD
PYPL - PAYPAL HOLDINGS INC
PYR - PYROGENESIS CANADA INC
PYXS - PYXIS ONCOLOGY INC
PZN - PZENA INVESTMENT MANAGM-CL A
PZZA - PAPA JOHN'S INTL INC
QCOM - QUALCOMM INC
QCRH - QCR HOLDINGS INC
QDEL - QUIDEL CORP
QFTA - QUANTUM FINTECH ACQUISITION
QGEN - QIAGEN N.V.
QIPT - QUIPT HOME MEDICAL CORP
QLGN - QUALIGEN THERAPEUTICS INC
QLI - QILIAN INTERNATIONAL HOLDING
QLYS - QUALYS INC
QMCO - QUANTUM CORP
QNST - QUINSTREET INC
QRHC - QUEST RESOURCE HOLDING CORP
QRTEA - QURATE RETAIL INC-SERIES A
QRTEB - QURATE RETAIL GROUP INC-B
QRVO - QORVO INC
QS - QUANTUMSCAPE CORP
QSI - QUANTUM-SI INC
QSR - RESTAURANT BRANDS INTERN
QTNT - QUOTIENT LTD
QTRX - QUANTERIX CORP
QTWO - Q2 HOLDINGS INC
QUAD - QUAD GRAPHICS INC
QUBT - QUANTUM COMPUTING INC
QUIK - QUICKLOGIC CORP
QUMU - QUMU CORP
QUOT - QUOTIENT TECHNOLOGY INC
QURE - UNIQURE NV
R - RYDER SYSTEM INC
RACB - RESEARCH ALLIANCE CORP II-A
RACE - FERRARI NV
RAD - RITE AID CORP
RADA - RADA ELECTRONIC INDS LTD
RADI - RADIUS GLOBAL INFRASTRUCTU-A
RAIL - FREIGHTCAR AMERICA INC
RAIN - RAIN THERAPEUTICS INC
RAM - ARIES I ACQUISITION CORP -A
RAMP - LIVERAMP HOLDINGS INC
RAND - RAND CAPITAL CORP
RANI - RANI THERAPEUTICS HOLDINGS-A
RAPT - RAPT THERAPEUTICS INC
RARE - ULTRAGENYX PHARMACEUTICAL IN
RAVE - RAVE RESTAURANT GROUP INC
RBA - RITCHIE BROS AUCTIONEERS
RBAC - REDBALL ACQUISITION CORP - A
RBB - RBB BANCORP
RBBN - RIBBON COMMUNICATIONS INC
RBCAA - REPUBLIC BANCORP INC-CLASS A
RBCN - RUBICON TECHNOLOGY INC
RBKB - RHINEBECK BANCORP INC
RBLX - ROBLOX CORP -CLASS A
RBNC - RELIANT BANCORP INC
RBOT - VICARIOUS SURGICAL INC
RCAT - RED CAT HOLDINGS INC
RCEL - AVITA MEDICAL INC
RCHG - RECHARGE ACQUISITION CORP-A
RCI - ROGERS COMMUNICATIONS INC-B
RCII - RENT-A-CENTER INC
RCKT - ROCKET PHARMACEUTICALS INC
RCKY - ROCKY BRANDS INC
RCL - ROYAL CARIBBEAN CRUISES LTD
RCLF - ROSECLIFF ACQUISITION CORP-A
RCM - R1 RCM INC
RCMT - RCM TECHNOLOGIES INC
RCON - RECON TECHNOLOGY LTD-CLASS A
RCRT - RECRUITER.COM GROUP INC
RCUS - ARCUS BIOSCIENCES INC
RDBX - REDBOX ENTERTAINMENT INC
RDCM - RADCOM LTD
RDFN - REDFIN CORP
RDI - READING INTERNATIONAL INC-A
RDIB - READING INTERNATIONAL INC-B
RDN - RADIAN GROUP INC
RDNT - RADNET INC
RDUS - RADIUS HEALTH INC
RDVT - RED VIOLET INC
RDW - REDWIRE CORP
RDWR - RADWARE LTD
RE - EVEREST RE GROUP LTD
REAL - REALREAL INC/THE
REAX - REAL BROKERAGE INC/THE
REE - REE AUTOMOTIVE LTD - CLASS A
REED - REED'S INC
REFI - CHICAGO ATLANTIC REAL ESTATE
REFR - RESEARCH FRONTIERS INC
REGI - RENEWABLE ENERGY GROUP INC
REGN - REGENERON PHARMACEUTICALS
REKR - REKOR SYSTEMS INC
RELI - RELIANCE GLOBAL GROUP INC
RELL - RICHARDSON ELEC LTD
RELY - REMITLY GLOBAL INC
RENO - RENOVARE ENVIRONMENTAL INC
RENT - RENT THE RUNWAY INC-A
REPH - RECRO PHARMA INC
REPL - REPLIMUNE GROUP INC
RES - RPC INC
RESN - RESONANT INC
RETA - REATA PHARMACEUTICALS INC-A
RETO - RETO ECO-SOLUTIONS INC
REV - REVLON INC-CLASS A
REVE - ALPINE ACQUISITION CORP
REVG - REV GROUP INC
REVH - REVOLUTION HEALTHCARE ACQU-A
REX - REX AMERICAN RESOURCES CORP
REYN - REYNOLDS CONSUMER PRODUCTS I
REZI - RESIDEO TECHNOLOGIES INC
RF - REGIONS FINANCIAL CORP
RFIL - RF INDUSTRIES LTD
RFL - RAFAEL HOLDINGS INC-CLASS B
RFP - RESOLUTE FOREST PRODUCTS
RGA - REINSURANCE GROUP OF AMERICA
RGC - REGENCELL BIOSCIENCE HOLDING
RGCO - RGC RESOURCES INC
RGEN - REPLIGEN CORP
RGF - REAL GOOD FOOD CO INC/THE
RGLD - ROYAL GOLD INC
RGLS - REGULUS THERAPEUTICS INC
RGNX - REGENXBIO INC
RGP - RESOURCES CONNECTION INC
RGR - STURM RUGER & CO INC
RGS - REGIS CORP
RH - RH
RHI - ROBERT HALF INTL INC
RIBT - RICEBRAN TECHNOLOGIES
RICK - RCI HOSPITALITY HOLDINGS INC
RICO - AGRICO ACQUISITION CORP-A
RIDE - LORDSTOWN MOTORS CORP-CL A
RIG - TRANSOCEAN LTD
RIGL - RIGEL PHARMACEUTICALS INC
RILY - B. RILEY FINANCIAL INC
RIOT - RIOT BLOCKCHAIN INC
RIVN - RIVIAN AUTOMOTIVE INC-A
RJF - RAYMOND JAMES FINANCIAL INC
RKDA - ARCADIA BIOSCIENCES INC
RKLB - ROCKET LAB USA INC
RKLY - ROCKLEY PHOTONICS HOLDINGS L
RKT - ROCKET COS INC-CLASS A
RKTA - ROCKET INTERNET GROWTH OPP-A
RL - RALPH LAUREN CORP
RLAY - RELAY THERAPEUTICS INC
RLGY - REALOGY HOLDINGS CORP
RLI - RLI CORP
RLMD - RELMADA THERAPEUTICS INC
RLYB - RALLYBIO CORP
RM - REGIONAL MANAGEMENT CORP
RMAX - RE/MAX HOLDINGS INC-CL A
RMBI - RICHMOND MUTUAL BANCORPORATI
RMBL - RUMBLEON INC-B
RMBS - RAMBUS INC
RMCF - ROCKY MOUNTAIN CHOC FACT INC
RMD - RESMED INC
RMGC - RMG ACQUISITION CORP III -A
RMNI - RIMINI STREET INC
RMO - ROMEO POWER INC
RMR - RMR GROUP INC/THE - A
RMTI - ROCKWELL MEDICAL INC
RNA - AVIDITY BIOSCIENCES INC
RNAZ - TRANSCODE THERAPEUTICS INC
RNDB - RANDOLPH BANCORP INC
RNG - RINGCENTRAL INC-CLASS A
RNGR - RANGER ENERGY SERVICES INC
RNR - RENAISSANCERE HOLDINGS LTD
RNST - RENASANT CORP
RNW - RENEW ENERGY GLOBAL PLC-A
RNWK - REALNETWORKS INC
RNXT - RENOVORX INC
ROAD - CONSTRUCTION PARTNERS INC-A
ROCC - RANGER OIL CORP-A
ROCG - ROTH CH ACQUISITION IV CO
ROCK - GIBRALTAR INDUSTRIES INC
ROCR - ROTH CH ACQUISITION III CO
ROG - ROGERS CORP
ROIV - ROIVANT SCIENCES LTD
ROK - ROCKWELL AUTOMATION INC
ROKU - ROKU INC
ROL - ROLLINS INC
ROLL - RBC BEARINGS INC
RONI - RICE ACQUISITION CORP II -A
ROOT - ROOT INC/OH -CLASS A
ROP - ROPER TECHNOLOGIES INC
ROSE - ROSE HILL ACQUISITION CORP-A
ROSS - ROSS ACQUISITION CORP II -A
ROST - ROSS STORES INC
ROVR - ROVER GROUP INC
RPAY - REPAY HOLDINGS CORP
RPD - RAPID7 INC
RPHM - RENEO PHARMACEUTICALS INC
RPID - RAPID MICRO BIOSYSTEMS INC-A
RPM - RPM INTERNATIONAL INC
RPRX - ROYALTY PHARMA PLC- CL A
RPTX - REPARE THERAPEUTICS INC
RRBI - RED RIVER BANCSHARES INC
RRC - RANGE RESOURCES CORP
RRD - RR DONNELLEY & SONS CO
RRGB - RED ROBIN GOURMET BURGERS
RRR - RED ROCK RESORTS INC-CLASS A
RRX - REGAL REXNORD CORP
RS - RELIANCE STEEL & ALUMINUM
RSG - REPUBLIC SERVICES INC
RSI - RUSH STREET INTERACTIVE INC
RSKD - RISKIFIED LTD-A
RSLS - RESHAPE LIFESCIENCES INC
RSSS - RESEARCH SOLUTIONS INC
RSVR - RESERVOIR MEDIA INC
RTX - RAYTHEON TECHNOLOGIES CORP
RUBY - RUBIUS THERAPEUTICS INC
RUN - SUNRUN INC
RUSHA - RUSH ENTERPRISES INC-CL A
RUSHB - RUSH ENTERPRISES INC - CL B
RUTH - RUTH'S HOSPITALITY GROUP INC
RVAC - RIVERVIEW ACQUISITION CORP-A
RVLV - REVOLVE GROUP INC
RVMD - REVOLUTION MEDICINES INC
RVNC - REVANCE THERAPEUTICS INC
RVPH - REVIVA PHARMACEUTICALS HOLDI
RVSB - RIVERVIEW BANCORP INC
RWAY - RUNWAY GROWTH FINANCE CORP
RWLK - REWALK ROBOTICS LTD
RXDX - PROMETHEUS BIOSCIENCES INC
RXRA - RXR ACQUISITION CORP- CL A
RXRX - RECURSION PHARMACEUTICALS-A
RXST - RXSIGHT INC
RXT - RACKSPACE TECHNOLOGY INC
RY - ROYAL BANK OF CANADA
RYAM - RAYONIER ADVANCED MATERIALS
RYAN - RYAN SPECIALTY GROUP HLDGS-A
RYI - RYERSON HOLDING CORP
RYTM - RHYTHM PHARMACEUTICALS INC
RZLT - REZOLUTE INC
S - SENTINELONE INC -CLASS A
SA - SEABRIDGE GOLD INC
SABR - SABRE CORP
SABS - SAB BIOTHERAPEUTICS INC
SAFM - SANDERSON FARMS INC
SAFT - SAFETY INSURANCE GROUP INC
SAGE - SAGE THERAPEUTICS INC
SAH - SONIC AUTOMOTIVE INC-CLASS A
SAIA - SAIA INC
SAIC - SCIENCE APPLICATIONS INTE
SAIL - SAILPOINT TECHNOLOGIES HOLDI
SAL - SALISBURY BANCORP INC
SALM - SALEM MEDIA GROUP INC
SAM - BOSTON BEER COMPANY INC-A
SAMA - SCHULTZE SPECIAL PURPOSE-A
SAMG - SILVERCREST ASSET MANAGEME-A
SANA - SANA BIOTECHNOLOGY INC
SANB - SANABY HEALTH ACQ CORP - A
SAND - SANDSTORM GOLD LTD
SANG - SANGOMA TECHNOLOGIES CORP
SANM - SANMINA CORP
SANW - S&W SEED CO
SAR - SARATOGA INVESTMENT CORP
SASR - SANDY SPRING BANCORP INC
SATS - ECHOSTAR CORP-A
SAVA - CASSAVA SCIENCES INC
SAVE - SPIRIT AIRLINES INC
SB - SAFE BULKERS INC
SBCF - SEACOAST BANKING CORP/FL
SBEA - SILVERBOX ENGAGED MERGER C-A
SBET - SHARPLINK GAMING LTD
SBFG - SB FINANCIAL GROUP INC
SBGI - SINCLAIR BROADCAST GROUP -A
SBH - SALLY BEAUTY HOLDINGS INC
SBII - SANDBRIDGE X2 CORP-A
SBLK - STAR BULK CARRIERS CORP
SBNY - SIGNATURE BANK
SBOW - SILVERBOW RESOURCES INC
SBSI - SOUTHSIDE BANCSHARES INC
SBT - STERLING BANCORP INC/MI
SBTX - SILVERBACK THERAPEUTICS INC
SBUX - STARBUCKS CORP
SC - SANTANDER CONSUMER USA HOLDI
SCAQ - STRATIM CLOUD ACQUISITION CO
SCCO - SOUTHERN COPPER CORP
SCHL - SCHOLASTIC CORP
SCHN - SCHNITZER STEEL INDS INC-A
SCHW - SCHWAB (CHARLES) CORP
SCI - SERVICE CORP INTERNATIONAL
SCKT - SOCKET MOBILE INC
SCL - STEPAN CO
SCLE - BROADSCALE ACQUISITION -CL A
SCM - STELLUS CAPITAL INVESTMENT C
SCMA - SEAPORT CALIBRE MATERIALS AC
SCOA - SCION TECH GROWTH I-CLASS A
SCOB - SCION TECH GROWTH II-CLASS A
SCOR - COMSCORE INC
SCPH - SCPHARMACEUTICALS INC
SCPL - SCIPLAY CORP-CLASS A
SCPS - SCOPUS BIOPHARMA INC
SCS - STEELCASE INC-CL A
SCSC - SCANSOURCE INC
SCU - SCULPTOR CAPITAL MANAGEMENT
SCVL - SHOE CARNIVAL INC
SCVX - SCVX CORP - CLASS A
SCWX - SECUREWORKS CORP - A
SCX - STARRETT (L.S.) CO  -CL A
SCYX - SCYNEXIS INC
SD - SANDRIDGE ENERGY INC
SDAC - SUSTAINABLE DEVELOPMENT AC-A
SDC - SMILEDIRECTCLUB INC
SDGR - SCHRODINGER INC
SDH - GLOBAL INTERNET OF PEOPLE IN
SDIG - STRONGHOLD DIGITAL MINING-A
SEAC - SEACHANGE INTERNATIONAL INC
SEAH - SPORTS ENTERTAINMENT ACQUI-A
SEAS - SEAWORLD ENTERTAINMENT INC
SEAT - VIVID SEATS INC - CLASS A
SEDA - SDCL EDGE ACQUISITION CORP-A
SEDG - SOLAREDGE TECHNOLOGIES INC
SEE - SEALED AIR CORP
SEED - ORIGIN AGRITECH LTD
SEEL - SEELOS THERAPEUTICS INC
SEER - SEER INC
SEIC - SEI INVESTMENTS COMPANY
SELB - SELECTA BIOSCIENCES INC
SEM - SELECT MEDICAL HOLDINGS CORP
SEMR - SEMRUSH HOLDINGS INC-A
SENEA - SENECA FOODS CORP - CL A
SENEB - SENECA FOODS CORP - CL B
SERA - SERA PROGNOSTICS INC-A
SESN - SESEN BIO INC
SEV - SONO GROUP NV
SF - STIFEL FINANCIAL CORP
SFBC - SOUND FINANCIAL BANCORP INC
SFBS - SERVISFIRST BANCSHARES INC
SFE - SAFEGUARD SCIENTIFICS INC
SFIX - STITCH FIX INC-CLASS A
SFL - SFL CORP LTD
SFM - SPROUTS FARMERS MARKET INC
SFNC - SIMMONS FIRST NATL CORP-CL A
SFST - SOUTHERN FIRST BANCSHARES
SFT - SHIFT TECHNOLOGIES INC
SG - SWEETGREEN INC - CLASS A
SGA - SAGA COMMUNICATIONS INC-CL A
SGBX - SG BLOCKS INC
SGC - SUPERIOR GROUP OF COS INC
SGEN - SEAGEN INC
SGFY - SIGNIFY HEALTH INC -CLASS A
SGH - SMART GLOBAL HOLDINGS INC
SGHT - SIGHT SCIENCES INC
SGII - SEAPORT GLOBAL ACQUISITION-A
SGLB - SIGMA LABS INC
SGMA - SIGMATRON INTERNATIONAL INC
SGML - SIGMA LITHIUM CORP
SGMO - SANGAMO THERAPEUTICS INC
SGMS - SCIENTIFIC GAMES CORP
SGRP - SPAR GROUP INC
SGRY - SURGERY PARTNERS INC
SGTX - SIGILON THERAPEUTICS INC
SGU - STAR GROUP LP
SHAC - SCP & CO HEALTHCARE ACQUIS-A
SHAK - SHAKE SHACK INC - CLASS A
SHBI - SHORE BANCSHARES INC
SHC - SOTERA HEALTH CO
SHCR - SHARECARE INC
SHEN - SHENANDOAH TELECOMMUNICATION
SHIP - SEANERGY MARITIME HOLDINGS
SHLS - SHOALS TECHNOLOGIES GROUP -A
SHOO - STEVEN MADDEN LTD
SHOP - SHOPIFY INC - CLASS A
SHPW - SHAPEWAYS HOLDINGS INC
SHQA - SHELTER ACQUISITION CORP I-A
SHW - SHERWIN-WILLIAMS CO/THE
SHYF - SHYFT GROUP INC/THE
SI - SILVERGATE CAPITAL CORP-CL A
SIBN - SI-BONE INC
SIDU - SIDUS SPACE INC-CL A
SIEB - SIEBERT FINANCIAL CORP
SIEN - SIENTRA INC
SIER - SIERRA LAKE ACQUISITION CO-A
SIG - SIGNET JEWELERS LTD
SIGA - SIGA TECHNOLOGIES INC
SIGI - SELECTIVE INSURANCE GROUP
SII - SPROTT INC
SILC - SILICOM LTD
SILK - SILK ROAD MEDICAL INC
SINO - SINO-GLOBAL SHIPPING AMERICA
SINT - SINTX TECHNOLOGIES INC
SIOX - SIO GENE THERAPIES INC
SIRI - SIRIUS XM HOLDINGS INC
SISI - SHINECO INC
SITE - SITEONE LANDSCAPE SUPPLY INC
SITM - SITIME CORP
SIVB - SVB FINANCIAL GROUP
SIX - SIX FLAGS ENTERTAINMENT CORP
SJ - SCIENJOY HOLDING CORP-A
SJI - SOUTH JERSEY INDUSTRIES
SJM - JM SMUCKER CO/THE
SJR - SHAW COMMUNICATIONS INC-B
SJW - SJW GROUP
SKE - SKEENA RESOURCES LTD
SKIL - SKILLSOFT CORP
SKIN - BEAUTY HEALTH CO/THE
SKLZ - SKILLZ INC
SKX - SKECHERS USA INC-CL A
SKY - SKYLINE CHAMPION CORP
SKYA - SKYDECK ACQUISITION CORP-A
SKYT - SKYWATER TECHNOLOGY INC
SKYW - SKYWEST INC
SLAB - SILICON LABORATORIES INC
SLAC - SOCIAL LEVERAGE ACQUISITIO-A
SLAM - SLAM CORP-A
SLB - SCHLUMBERGER LTD
SLCA - US SILICA HOLDINGS INC
SLCR - SILVER CREST ACQUISITION C-A
SLDB - SOLID BIOSCIENCES INC
SLDP - SOLID POWER INC
SLF - SUN LIFE FINANCIAL INC
SLGC - SOMALOGIC INC
SLGG - SUPER LEAGUE GAMING INC
SLGL - SOL-GEL TECHNOLOGIES LTD
SLGN - SILGAN HOLDINGS INC
SLHG - SKYLIGHT HEALTH GROUP INC
SLM - SLM CORP
SLNG - STABILIS SOLUTIONS INC
SLNH - SOLUNA HOLDINGS INC
SLNO - SOLENO THERAPEUTICS INC
SLP - SIMULATIONS PLUS INC
SLQT - SELECTQUOTE INC
SLRC - SLR INVESTMENT CORP
SLRX - SALARIUS PHARMACEUTICALS INC
SLS - SELLAS LIFE SCIENCES GROUP I
SLVM - SYLVAMO CORP
SLVR - SILVERSPAC INC-CL A
SM - SM ENERGY CO
SMAP - SPORTSMAP TECH ACQUISITION C
SMAR - SMARTSHEET INC-CLASS A
SMBC - SOUTHERN MISSOURI BANCORP
SMBK - SMARTFINANCIAL INC
SMCI - SUPER MICRO COMPUTER INC
SMED - SHARPS COMPLIANCE CORP
SMFR - SEMA4 HOLDINGS CORP
SMG - SCOTTS MIRACLE-GRO CO
SMHI - SEACOR MARINE HOLDINGS INC
SMID - SMITH-MIDLAND CORP
SMIH - SUMMIT HEALTHCARE ACQ-A
SMIT - SCHMITT INDUSTRIES INC
SMLR - SEMLER SCIENTIFIC INC
SMMF - SUMMIT FINANCIAL GROUP INC
SMMT - SUMMIT THERAPEUTICS INC
SMP - STANDARD MOTOR PRODS
SMPL - SIMPLY GOOD FOODS CO/THE
SMRT - SMARTRENT INC
SMSI - SMITH MICRO SOFTWARE INC
SMTC - SEMTECH CORP
SMTI - SANARA MEDTECH INC
SMWB - SIMILARWEB LTD
SNA - SNAP-ON INC
SNAP - SNAP INC - A
SNAX - STRYVE FOODS INC-CLASS A
SNBR - SLEEP NUMBER CORP
SNCE - SCIENCE 37 HOLDINGS INC
SNCR - SYNCHRONOSS TECHNOLOGIES INC
SNCY - SUN COUNTRY AIRLINES HOLDING
SND - SMART SAND INC
SNDA - SONIDA SENIOR LIVING INC
SNDL - SUNDIAL GROWERS INC
SNDR - SCHNEIDER NATIONAL INC-CL B
SNDX - SYNDAX PHARMACEUTICALS INC
SNES - SENESTECH INC
SNEX - STONEX GROUP INC
SNFCA - SECURITY NATL FINL CORP-CL A
SNGX - SOLIGENIX INC
SNII - SUPERNOVA PARTNERS ACQUISI-A
SNOA - SONOMA PHARMACEUTICALS INC
SNOW - SNOWFLAKE INC-CLASS A
SNPO - SNAP ONE HOLDINGS CORP
SNPS - SYNOPSYS INC
SNPX - SYNAPTOGENIX INC
SNRH - SENIOR CONNECT ACQUISITION-A
SNSE - SENSEI BIOTHERAPEUTICS INC
SNT - SENSTAR TECHNOLOGIES LTD
SNTG - SENTAGE HOLDINGS INC
SNV - SYNOVUS FINANCIAL CORP
SNX - TD SYNNEX CORP
SO - SOUTHERN CO/THE
SOFI - SOFI TECHNOLOGIES INC
SOI - SOLARIS OILFIELD INFRAST-A
SOLO - ELECTRAMECCANICA VEHICLES CO
SON - SONOCO PRODUCTS CO
SONM - SONIM TECHNOLOGIES INC
SONN - SONNET BIOTHERAPEUTICS HOLDI
SONO - SONOS INC
SONX - SONENDO INC
SOPA - SOCIETY PASS INC
SOPH - SOPHIA GENETICS SA
SOTK - SONO-TEK CORP
SOVO - SOVOS BRANDS INC
SP - SP PLUS CORP
SPAQ - SPARTAN ACQUISITION III-A
SPB - SPECTRUM BRANDS HOLDINGS INC
SPCB - SUPERCOM LTD
SPCE - VIRGIN GALACTIC HOLDINGS INC
SPFI - SOUTH PLAINS FINANCIAL INC
SPGI - S&P GLOBAL INC
SPGS - SIMON PROPERTY GROUP ACQUI-A
SPI - SPI ENERGY CO LTD
SPIR - SPIRE GLOBAL INC
SPK - SPK ACQUISITION CORP
SPKB - SILVER SPIKE ACQUISITION-A
SPLK - SPLUNK INC
SPNE - SEASPINE HOLDINGS CORP
SPNS - SAPIENS INTERNATIONAL CORP
SPNT - SIRIUSPOINT LTD
SPOK - SPOK HOLDINGS INC
SPOT - SPOTIFY TECHNOLOGY SA
SPPI - SPECTRUM PHARMACEUTICALS INC
SPR - SPIRIT AEROSYSTEMS HOLD-CL A
SPRB - SPRUCE BIOSCIENCES INC
SPRC - SCISPARC LTD
SPRO - SPERO THERAPEUTICS INC
SPSC - SPS COMMERCE INC
SPT - SPROUT SOCIAL INC - CLASS A
SPTK - SPORTSTEK ACQUISITION CORP-A
SPTN - SPARTANNASH CO
SPWH - SPORTSMAN'S WAREHOUSE HOLDIN
SPWR - SUNPOWER CORP
SPXC - SPX CORP
SQ - BLOCK INC
SQFT - PRESIDIO PROPERTY TRUST - A
SQL - SEQLL INC
SQSP - SQUARESPACE INC - CLASS A
SQZ - SQZ BIOTECHNOLOGIES CO
SR - SPIRE INC
SRAD - SPORTRADAR GROUP AG-A
SRAX - SRAX INC
SRCE - 1ST SOURCE CORP
SRCL - STERICYCLE INC
SRDX - SURMODICS INC
SRE - SEMPRA ENERGY
SREV - SERVICESOURCE INTERNATIONAL
SRGA - SURGALIGN HOLDINGS INC
SRI - STONERIDGE INC
SRL - SCULLY ROYALTY LTD
SRNE - SORRENTO THERAPEUTICS INC
SRPT - SAREPTA THERAPEUTICS INC
SRRA - SIERRA ONCOLOGY INC
SRRK - SCHOLAR ROCK HOLDING CORP
SRSA - SARISSA CAPITAL ACQUISITI-A
SRT - STARTEK INC
SRTS - SENSUS HEALTHCARE INC
SRZN - SURROZEN INC
SSAA - SCIENCE STRATEGIC ACQUISIT-A
SSB - SOUTHSTATE CORP
SSBI - SUMMIT STATE BANK
SSBK - SOUTHERN STATES BANCSHARES
SSD - SIMPSON MANUFACTURING CO INC
SSKN - STRATA SKIN SCIENCES INC
SSNC - SS&C TECHNOLOGIES HOLDINGS
SSNT - SILVERSUN TECHNOLOGIES INC
SSP - EW SCRIPPS CO/THE-A
SSRM - SSR MINING INC
SSSS - SURO CAPITAL CORP
SSTI - SHOTSPOTTER INC
SSTK - SHUTTERSTOCK INC
SSU - SIGNA SPORTS UNITED NV
SSYS - STRATASYS LTD
ST - SENSATA TECHNOLOGIES HOLDING
STAA - STAAR SURGICAL CO
STAB - STATERA BIOPHARMA INC
STAF - STAFFING 360 SOLUTIONS INC
STBA - S & T BANCORP INC
STC - STEWART INFORMATION SERVICES
STCN - STEEL CONNECT INC
STE - STERIS PLC
STEM - STEM INC
STEP - STEPSTONE GROUP INC-CLASS A
STER - STERLING CHECK CORP
STFC - STATE AUTO FINANCIAL CORP
STGW - STAGWELL INC
STIM - NEURONETICS INC
STKL - SUNOPTA INC
STKS - ONE GROUP HOSPITALITY INC/TH
STL - STERLING BANCORP/DE
STLA - STELLANTIS NV
STLD - STEEL DYNAMICS INC
STN - STANTEC INC
STNE - STONECO LTD-A
STNG - SCORPIO TANKERS INC
STOK - STOKE THERAPEUTICS INC
STON - STONEMOR INC
STRA - STRATEGIC EDUCATION INC
STRC - SARCOS TECHNOLOGY AND ROBOTI
STRE - SUPERNOVA PARTNERS ACQUISI-A
STRL - STERLING CONSTRUCTION CO
STRM - STREAMLINE HEALTH SOLUTIONS
STRN - STRAN & CO INC
STRO - SUTRO BIOPHARMA INC
STRR - STAR EQUITY HOLDINGS INC
STRS - STRATUS PROPERTIES INC
STRT - STRATTEC SECURITY CORP
STSA - SATSUMA PHARMACEUTICALS INC
STT - STATE STREET CORP
STTK - SHATTUCK LABS INC
STVN - STEVANATO GROUP SPA
STX - SEAGATE TECHNOLOGY HOLDINGS
STXB - SPIRIT OF TEXAS BANCSHARES I
STZ - CONSTELLATION BRANDS INC-A
STZ.B - CONSTELLATION BRANDS INC-B
SU - SUNCOR ENERGY INC
SUM - SUMMIT MATERIALS INC -CL A
SUMO - SUMO LOGIC INC
SUMR - SUMMER INFANT INC
SUNL - SUNLIGHT FINANCIAL HOLDINGS
SUNS - SLR SENIOR INVESTMENT CORP
SUNW - SUNWORKS INC
SUP - SUPERIOR INDUSTRIES INTL
SUPN - SUPERNUS PHARMACEUTICALS INC
SURF - SURFACE ONCOLOGY INC
SURG - SURGEPAYS INC
SV - SPRING VALLEY ACQUIS-CLASS A
SVA - SINOVAC BIOTECH LTD
SVFA - SVF INVESTMENT CORP-CL A
SVFB - SVF INVESTMENT CORP 2-CLS A
SVFC - SVF INVESTMENT CORP 3-CLS A
SVFD - SAVE FOODS INC
SVRA - SAVARA INC
SVVC - FIRSTHAND TECHNOLOGY VALUE
SWAG - SOFTWARE ACQUISITION GROUP-A
SWAV - SHOCKWAVE MEDICAL INC
SWBI - SMITH & WESSON BRANDS INC
SWCH - SWITCH INC - A
SWET - ATHLON ACQUISITION CORP-A
SWI - SOLARWINDS CORP
SWIM - LATHAM GROUP INC
SWIR - SIERRA WIRELESS INC
SWK - STANLEY BLACK & DECKER INC
SWKH - SWK HOLDINGS CORP
SWKS - SKYWORKS SOLUTIONS INC
SWM - SCHWEITZER-MAUDUIT INTL INC
SWN - SOUTHWESTERN ENERGY CO
SWSS - SPRINGWATER SPECIAL SITUATIO
SWTX - SPRINGWORKS THERAPEUTICS INC
SWX - SOUTHWEST GAS HOLDINGS INC
SXC - SUNCOKE ENERGY INC
SXI - STANDEX INTERNATIONAL CORP
SXT - SENSIENT TECHNOLOGIES CORP
SXTC - CHINA SXT PHARMACEUTICALS IN
SYBT - STOCK YARDS BANCORP INC
SYBX - SYNLOGIC INC
SYF - SYNCHRONY FINANCIAL
SYK - STRYKER CORP
SYNA - SYNAPTICS INC
SYNH - SYNEOS HEALTH INC
SYNL - SYNALLOY CORP
SYPR - SYPRIS SOLUTIONS INC
SYRS - SYROS PHARMACEUTICALS INC
SYTA - SIYATA MOBILE INC
SYY - SYSCO CORP
T - AT&T INC
TA - TRAVELCENTERS OF AMERICA INC
TAC - TRANSALTA CORP
TACA - TREPONT ACQUISITION CORP I-A
TACO - DEL TACO RESTAURANTS INC
TACT - TRANSACT TECHNOLOGIES INC
TAIT - TAITRON COMPONENTS INC-CL A
TALK - TALKSPACE INC
TALO - TALOS ENERGY INC
TALS - TALARIS THERAPEUTICS INC
TANH - TANTECH HOLDINGS LTD
TAOP - TAOPING INC
TAP - MOLSON COORS BEVERAGE CO - B
TAP.A - MOLSON COORS BEVERAGE CO - A
TARA - PROTARA THERAPEUTIC INC
TARO - TARO PHARMACEUTICAL INDUS
TARS - TARSUS PHARMACEUTICALS INC
TASK - TASKUS INC-A
TAST - CARROLS RESTAURANT GROUP INC
TATT - TAT TECHNOLOGIES LTD
TAYD - TAYLOR DEVICES INC
TBBK - BANCORP INC/THE
TBCP - THUNDER BRIDGE CAPITAL PAR-A
TBI - TRUEBLUE INC
TBK - TRIUMPH BANCORP INC
TBLA - TABOOLA.COM LTD
TBLT - TOUGHBUILT INDUSTRIES INC
TBNK - TERRITORIAL BANCORP INC
TBPH - THERAVANCE BIOPHARMA INC
TBSA - TB SA ACQUISITION CORP -A
TCAC - TUATARA CAPITAL ACQUISITIO-A
TCBC - TC BANCSHARES INC
TCBI - TEXAS CAPITAL BANCSHARES INC
TCBK - TRICO BANCSHARES
TCBS - TEXAS COMMUNITY BANCSHARES
TCBX - THIRD COAST BANCSHARES INC
TCDA - TRICIDA INC
TCFC - COMMUNITY FINANCIAL CORP/THE
TCI - TRANSCONTINENTAL REALTY INV
TCMD - TACTILE SYSTEMS TECHNOLOGY I
TCN - TRICON RESIDENTIAL INC
TCON - TRACON PHARMACEUTICALS INC
TCPC - BLACKROCK TCP CAPITAL CORP
TCRR - TCR2 THERAPEUTICS INC
TCRX - TSCAN THERAPEUTICS INC
TCS - CONTAINER STORE GROUP INC/TH
TCVA - TCV ACQUISITION CORP-A
TCX - TUCOWS INC-CLASS A
TD - TORONTO-DOMINION BANK
TDC - TERADATA CORP
TDG - TRANSDIGM GROUP INC
TDOC - TELADOC HEALTH INC
TDS - TELEPHONE AND DATA SYSTEMS
TDUP - THREDUP INC - CLASS A
TDW - TIDEWATER INC
TDY - TELEDYNE TECHNOLOGIES INC
TEAM - ATLASSIAN CORP PLC-CLASS A
TECH - BIO-TECHNE CORP
TECK - TECK RESOURCES LTD-CLS B
TEKK - TEKKORP DIGITAL ACQUISITIO-A
TEL - TE CONNECTIVITY LTD
TELA - TELA BIO INC
TEN - TENNECO INC-CLASS A
TENB - TENABLE HOLDINGS INC
TENX - TENAX THERAPEUTICS INC
TER - TERADYNE INC
TERN - TERNS PHARMACEUTICALS INC
TESS - TESSCO TECHNOLOGIES INC
TETC - TECH AND ENERGY TRANSITION-A
TEX - TEREX CORP
TFC - TRUIST FINANCIAL CORP
TFFP - TFF PHARMACEUTICALS INC
TFII - TFI INTERNATIONAL INC
TFSL - TFS FINANCIAL CORP
TFX - TELEFLEX INC
TG - TREDEGAR CORP
TGA - TRANSGLOBE ENERGY CORP
TGH - TEXTAINER GROUP HOLDINGS LTD
TGI - TRIUMPH GROUP INC
TGLS - TECNOGLASS INC
TGNA - TEGNA INC
TGP - TEEKAY LNG PARTNERS LP
TGT - TARGET CORP
TGTX - TG THERAPEUTICS INC
TGVC - TG VENTURE ACQUISITION CORP
TH - TARGET HOSPITALITY CORP
THAC - THRIVE ACQUISITION CORP - A
THC - TENET HEALTHCARE CORP
THCA - TUSCAN HOLDINGS CORP II
THCP - THUNDER BRIDGE CAPITAL PAR-A
THFF - FIRST FINANCIAL CORP/INDIANA
THG - HANOVER INSURANCE GROUP INC/
THMO - THERMOGENESIS HOLDINGS INC
THO - THOR INDUSTRIES INC
THR - THERMON GROUP HOLDINGS INC
THRM - GENTHERM INC
THRN - THORNE HEALTHTECH INC
THRX - THESEUS PHARMACEUTICALS INC
THRY - THRYV HOLDINGS INC
THS - TREEHOUSE FOODS INC
THTX - THERATECHNOLOGIES INC
TIG - TREAN INSURANCE GROUP INC
TIGO - MILLICOM INTL CELLULAR S.A.
TIL - INSTIL BIO INC
TILE - INTERFACE INC
TINV - TIGA ACQUISITION CORP- CL A
TIOA - TIO TECH A- CLASS A
TIPT - TIPTREE INC
TIRX - TIAN RUIXIANG HOLDINGS LTD-A
TISI - TEAM INC
TITN - TITAN MACHINERY INC
TIVC - TIVIC HEALTH SYSTEMS INC
TIXT - TELUS INTERNATIONAL CDA INC
TJX - TJX COMPANIES INC
TK - TEEKAY CORP
TKNO - ALPHA TEKNOVA INC
TKR - TIMKEN CO
TLGA - TLG ACQUISITION ONE COR-CL A
TLIS - TALIS BIOMEDICAL CORP
TLMD - SOC TELEMED INC
TLRY - TILRAY INC-CLASS 2 COMMON
TLS - TELOS CORPORATION
TLSA - TIZIANA LIFE SCIENCES LTD
TLYS - TILLY'S INC-CLASS A SHRS
TMAC - MUSIC ACQUISITION CORP/THE-A
TMC - TMC THE METALS CO INC
TMCI - TREACE MEDICAL CONCEPTS INC
TMDI - TITAN MEDICAL INC
TMDX - TRANSMEDICS GROUP INC
TMHC - TAYLOR MORRISON HOME CORP
TMKR - TASTEMAKER ACQUISITION COR-A
TMO - THERMO FISHER SCIENTIFIC INC
TMPM - TURMERIC ACQUISITION CORP-A
TMST - TIMKENSTEEL CORP
TMUS - T-MOBILE US INC
TMX - TERMINIX GLOBAL HOLDINGS INC
TNC - TENNANT CO
TNDM - TANDEM DIABETES CARE INC
TNET - TRINET GROUP INC
TNGX - TANGO THERAPEUTICS INC
TNK - TEEKAY TANKERS LTD-CLASS A
TNL - TRAVEL + LEISURE CO
TNP - TSAKOS ENERGY NAVIGATION LTD
TNXP - TONIX PHARMACEUTICALS HOLDIN
TNYA - TENAYA THERAPEUTICS INC
TOI - ONCOLOGY INSTITUTE INC/THE
TOL - TOLL BROTHERS INC
TOMZ - TOMI ENVIRONMENTAL SOLUTIONS
TOPS - TOP SHIPS INC
TOST - TOAST INC-CLASS A
TOWN - TOWNE BANK
TPB - TURNING POINT BRANDS INC
TPBA - TPB ACQUISITION CORP I-CL A
TPC - TUTOR PERINI CORP
TPGY - TPG PACE BENEFICIAL FIN-CL A
TPH - TRI POINTE HOMES INC
TPIC - TPI COMPOSITES INC
TPL - TEXAS PACIFIC LAND CORP
TPR - TAPESTRY INC
TPST - TEMPEST THERAPEUTICS INC
TPTX - TURNING POINT THERAPEUTICS I
TPVG - TRIPLEPOINT VENTURE GROWTH B
TPX - TEMPUR SEALY INTERNATIONAL I
TR - TOOTSIE ROLL INDS
TRC - TEJON RANCH CO
TRCA - TWIN RIDGE CAPITAL ACQUISI-A
TRDA - ENTRADA THERAPEUTICS INC
TREB - TREBIA ACQUISITION CORP-A
TREC - TRECORA RESOURCES
TREE - LENDINGTREE INC
TREX - TREX COMPANY INC
TRGP - TARGA RESOURCES CORP
TRHC - TABULA RASA HEALTHCARE INC
TRI - THOMSON REUTERS CORP
TRIN - TRINITY CAPITAL INC
TRIP - TRIPADVISOR INC
TRIS - TRISTAR ACQUISITION I CORP-A
TRIT - TRITERRAS INC-CLASS A
TRKA - TROIKA MEDIA GROUP INC
TRMB - TRIMBLE INC
TRMD - TORM PLC-A
TRMK - TRUSTMARK CORP
TRN - TRINITY INDUSTRIES INC
TRNS - TRANSCAT INC
TRON - CORNER GROWTH ACQUISITION -A
TROO - TROOPS INC
TROW - T ROWE PRICE GROUP INC
TROX - TRONOX HOLDINGS PLC- A
TRP - TC ENERGY CORP
TRQ - TURQUOISE HILL RESOURCES LTD
TRS - TRIMAS CORP
TRST - TRUSTCO BANK CORP NY
TRTL - TORTOISEECOFIN ACQUISITION-A
TRTN - TRITON INTERNATIONAL LTD
TRU - TRANSUNION
TRUE - TRUECAR INC
TRUP - TRUPANION INC
TRV - TRAVELERS COS INC/THE
TRVI - TREVI THERAPEUTICS INC
TRVN - TREVENA INC
TSAT - TELESAT CORP
TSBK - TIMBERLAND BANCORP INC
TSC - TRISTATE CAPITAL HLDGS INC
TSCO - TRACTOR SUPPLY COMPANY
TSE - TRINSEO PLC
TSEM - TOWER SEMICONDUCTOR LTD
TSHA - TAYSHA GENE THERAPIES INC
TSIB - TISHMAN SPEYER INNOVATI-CL A
TSLA - TESLA INC
TSLX - SIXTH STREET SPECIALTY LENDI
TSN - TYSON FOODS INC-CL A
TSP - TUSIMPLE HOLDINGS INC - A
TSPQ - TCW SPECIAL PURPOSE ACQ-CL A
TSQ - TOWNSQUARE MEDIA INC - CL A
TSRI - TSR INC
TSVT - 2SEVENTY BIO INC
TT - TRANE TECHNOLOGIES PLC
TTC - TORO CO
TTCF - TATTOOED CHEF INC
TTD - TRADE DESK INC/THE -CLASS A
TTEC - TTEC HOLDINGS INC
TTEK - TETRA TECH INC
TTGT - TECHTARGET
TTI - TETRA TECHNOLOGIES INC
TTMI - TTM TECHNOLOGIES
TTNP - TITAN PHARMACEUTICALS INC
TTOO - T2 BIOSYSTEMS INC
TTSH - TILE SHOP HLDGS INC
TTWO - TAKE-TWO INTERACTIVE SOFTWRE
TU - TELUS CORP
TUEM - TUESDAY MORNING CORP
TUFN - TUFIN SOFTWARE TECHNOLOGIES
TUGC - TRADEUP GLOBAL CORP-A
TUP - TUPPERWARE BRANDS CORP
TUSK - MAMMOTH ENERGY SERVICES INC
TVAC - THAYER VENTURES ACQUISITIO-A
TVTX - TRAVERE THERAPEUTICS INC
TVTY - TIVITY HEALTH INC
TW - TRADEWEB MARKETS INC-CLASS A
TWCB - BILANDER ACQUISITION CORP-A
TWI - TITAN INTERNATIONAL INC
TWIN - TWIN DISC INC
TWKS - THOUGHTWORKS HOLDING INC
TWLO - TWILIO INC - A
TWLV - TWELVE SEAS INVTMNT CO II -A
TWND - TAILWIND ACQUISITION CORP-A
TWNI - TAILWIND INTERNATIONAL ACQ-A
TWNK - HOSTESS BRANDS INC
TWNT - TAILWIND TWO ACQUISITION-A
TWOA - TWO - CLASS A
TWOU - 2U INC
TWST - TWIST BIOSCIENCE CORP
TWTR - TWITTER INC
TXG - 10X GENOMICS INC-CLASS A
TXMD - THERAPEUTICSMD INC
TXN - TEXAS INSTRUMENTS INC
TXRH - TEXAS ROADHOUSE INC
TXT - TEXTRON INC
TYL - TYLER TECHNOLOGIES INC
TYME - TYME TECHNOLOGIES INC
TYRA - TYRA BIOSCIENCES INC
TZOO - TRAVELZOO
TZPS - TZP STRATEGIES ACQUISI-CL A
U - UNITY SOFTWARE INC
UA - UNDER ARMOUR INC-CLASS C
UAA - UNDER ARMOUR INC-CLASS A
UAL - UNITED AIRLINES HOLDINGS INC
UBCP - UNITED BANCORP INC/OHIO
UBER - UBER TECHNOLOGIES INC
UBFO - UNITED SECURITY BANCSHARE/CA
UBOH - UNITED BANCSHARES INC/OHIO
UBS - UBS GROUP AG-REG
UBSI - UNITED BANKSHARES INC
UBX - UNITY BIOTECHNOLOGY INC
UCBI - UNITED COMMUNITY BANKS/GA
UCTT - ULTRA CLEAN HOLDINGS INC
UDMY - UDEMY INC
UEIC - UNIVERSAL ELECTRONICS INC
UEPS - NET 1 UEPS TECHNOLOGIES INC
UFCS - UNITED FIRE GROUP INC
UFI - UNIFI INC
UFPI - UFP INDUSTRIES INC
UFPT - UFP TECHNOLOGIES INC
UG - UNITED GUARDIAN INC
UGI - UGI CORP
UGRO - URBAN-GRO INC
UHAL - AMERCO
UHS - UNIVERSAL HEALTH SERVICES-B
UI - UBIQUITI INC
UIHC - UNITED INSURANCE HOLDINGS CO
UIS - UNISYS CORP
UK - UCOMMUNE INTERNATIONAL LTD-A
ULBI - ULTRALIFE CORP
ULCC - FRONTIER GROUP HOLDINGS INC
ULH - UNIVERSAL LOGISTICS HOLDINGS
ULTA - ULTA BEAUTY INC
UMBF - UMB FINANCIAL CORP
UMPQ - UMPQUA HOLDINGS CORP
UNAM - UNICO AMERICAN CORP
UNB - UNION BANKSHARES INC /VT
UNCY - UNICYCIVE THERAPEUTICS INC
UNF - UNIFIRST CORP/MA
UNFI - UNITED NATURAL FOODS INC
UNH - UNITEDHEALTH GROUP INC
UNM - UNUM GROUP
UNP - UNION PACIFIC CORP
UNTY - UNITY BANCORP INC
UNVR - UNIVAR SOLUTIONS INC
UONE - URBAN ONE INC
UONEK - URBAN ONE INC
UP - WHEELS UP EXPERIENCE INC
UPC - UNIVERSE PHARMACEUTICALS INC
UPH - UPHEALTH INC
UPLD - UPLAND SOFTWARE INC
UPS - UNITED PARCEL SERVICE-CL B
UPST - UPSTART HOLDINGS INC
UPTD - TRADEUP ACQUISITION CORP
UPWK - UPWORK INC
URBN - URBAN OUTFITTERS INC
URGN - UROGEN PHARMA LTD
URI - UNITED RENTALS INC
UROY - URANIUM ROYALTY CORP
USAK - USA TRUCK INC
USAP - UNIVERSAL STAINLESS & ALLOY
USAU - US GOLD CORP
USB - US BANCORP
USCB - US CENTURY BANK-CLASS A
USCT - TKB CRITICAL TECHNOLOGIES -A
USEG - U S ENERGY CORP - WYOMING
USER - USERTESTING INC
USFD - US FOODS HOLDING CORP
USIO - USIO INC
USLM - UNITED STATES LIME & MINERAL
USM - US CELLULAR CORP
USNA - USANA HEALTH SCIENCES INC
USPH - U.S. PHYSICAL THERAPY INC
USWS - US WELL SERVICES INC
USX - US XPRESS ENTERPRISES INC -A
UTHR - UNITED THERAPEUTICS CORP
UTI - UNIVERSAL TECHNICAL INSTITUT
UTL - UNITIL CORP
UTMD - UTAH MEDICAL PRODUCTS INC
UTME - UTIME LTD
UTRS - MINERVA SURGICAL INC
UTSI - UTSTARCOM HOLDINGS CORP
UTZ - UTZ BRANDS INC
UVE - UNIVERSAL INSURANCE HOLDINGS
UVSP - UNIVEST FINANCIAL CORP
UVV - UNIVERSAL CORP/VA
UWMC - UWM HOLDINGS CORP
V - VISA INC-CLASS A SHARES
VABK - VIRGINIA NATIONAL BANKSHARES
VAC - MARRIOTT VACATIONS WORLD
VAL - VALARIS LTD
VALU - VALUE LINE INC
VAPO - VAPOTHERM INC
VAQC - VECTOR ACQUISITION CORP II-A
VATE - INNOVATE CORP
VAXX - VAXXINITY INC-A
VBFC - VILLAGE BANK AND TRUST FINAN
VBIV - VBI VACCINES INC
VBLT - VASCULAR BIOGENICS LTD
VBNK - VERSABANK
VBTX - VERITEX HOLDINGS INC
VC - VISTEON CORP
VCEL - VERICEL CORP
VCKA - VICKERS VANTAGE CORP I
VCNX - VACCINEX INC
VCRA - VOCERA COMMUNICATIONS INC
VCSA - VACASA INC -CL A
VCTR - VICTORY CAPITAL HOLDING - A
VCXA - 10X CAPITAL VENTURE ACQUIS-A
VCYT - VERACYTE INC
VEC - VECTRUS INC
VECO - VEECO INSTRUMENTS INC
VECT - VECTIVBIO HOLDING AG
VEEE - TWIN VEE POWERCATS CO
VEEV - VEEVA SYSTEMS INC-CLASS A
VEL - VELOCITY FINANCIAL INC
VELO - VELOCITY ACQUISITION CORP-A
VENA - VENUS ACQUISITION CORP
VERA - VERA THERAPEUTICS INC
VERB - VERB TECHNOLOGY CO INC
VERI - VERITONE INC
VERO - VENUS CONCEPT INC
VERU - VERU INC
VERV - VERVE THERAPEUTICS INC
VERX - VERTEX INC - CLASS A
VERY - VERICITY INC
VET - VERMILION ENERGY INC
VEV - VICINITY MOTOR CORP
VFC - VF CORP
VFF - VILLAGE FARMS INTERNATIONAL
VG - VONAGE HOLDINGS CORP
VGFC - VERY GOOD FOOD CO INC/THE
VGII - VIRGIN GROUP ACQUISITION C-A
VGR - VECTOR GROUP LTD
VHC - VIRNETX HOLDING CORP
VHI - VALHI INC
VIA - VIA RENEWABLES INC
VIAC - VIACOMCBS INC - CLASS B
VIACA - VIACOMCBS INC - CLASS A
VIAV - VIAVI SOLUTIONS INC
VICR - VICOR CORP
VIEW - VIEW INC
VII - 7GC & CO HOLDINGS INC -CL A
VINC - VINCERX PHARMA INC
VINO - GAUCHO GROUP HOLDINGS INC
VINP - VINCI PARTNERS INVESTMENTS-A
VIR - VIR BIOTECHNOLOGY INC
VIRC - VIRCO MFG CORPORATION
VIRI - VIRIOS THERAPEUTICS INC
VIRT - VIRTU FINANCIAL INC-CLASS A
VIRX - VIRACTA THERAPEUTICS INC
VISL - VISLINK TECHNOLOGIES INC
VITL - VITAL FARMS INC
VIVE - VIVEVE MEDICAL INC
VIVO - MERIDIAN BIOSCIENCE INC
VKTX - VIKING THERAPEUTICS INC
VLAT - VALOR LATITUDE ACQUISITION-A
VLCN - VOLCON INC
VLD - VELO3D INC
VLDR - VELODYNE LIDAR INC
VLGEA - VILLAGE SUPER MARKET-CLASS A
VLN - VALENS SEMICONDUCTOR LTD
VLNS - VALENS CO INC/THE
VLO - VALERO ENERGY CORP
VLON - VALLON PHARMACEUTICALS INC
VLTA - VOLTA INC
VLY - VALLEY NATIONAL BANCORP
VMAC - VISTAS MEDIA ACQUISITION C-A
VMAR - VISION MARINE TECHNOLOGIES
VMC - VULCAN MATERIALS CO
VMD - VIEMED HEALTHCARE INC
VMEO - VIMEO INC
VMI - VALMONT INDUSTRIES
VMW - VMWARE INC-CLASS A
VNCE - VINCE HOLDING CORP
VNDA - VANDA PHARMACEUTICALS INC
VNE - VEONEER INC
VNOM - VIPER ENERGY PARTNERS LP
VNT - VONTIER CORP
VNTR - VENATOR MATERIALS PLC
VOR - VOR BIOPHARMA INC
VOXX - VOXX INTERNATIONAL CORP
VOYA - VOYA FINANCIAL INC
VPCB - VPC IMPACT ACQUISITION HOL-A
VPCC - VPC IMPACT ACQUISITION HOL-A
VPG - VISHAY PRECISION GROUP
VQS - VIQ SOLUTIONS INC
VRA - VERA BRADLEY INC
VRAR - GLIMPSE GROUP INC/THE
VRAY - VIEWRAY INC
VRCA - VERRICA PHARMACEUTICALS INC
VRDN - VIRIDIAN THERAPEUTICS INC
VREX - VAREX IMAGING CORP
VRM - VROOM INC
VRME - VERIFYME INC
VRNS - VARONIS SYSTEMS INC
VRNT - VERINT SYSTEMS INC
VRPX - VIRPAX PHARMACEUTICALS INC
VRRM - VERRA MOBILITY CORP
VRS - VERSO CORP - A
VRSK - VERISK ANALYTICS INC
VRSN - VERISIGN INC
VRT - VERTIV HOLDINGS CO
VRTS - VIRTUS INVESTMENT PARTNERS
VRTV - VERITIV CORP
VRTX - VERTEX PHARMACEUTICALS INC
VS - VERSUS SYSTEMS INC
VSAT - VIASAT INC
VSCO - VICTORIA'S SECRET & CO
VSEC - VSE CORP
VSH - VISHAY INTERTECHNOLOGY INC
VST - VISTRA CORP
VSTA - VASTA PLATFORM LTD
VSTM - VERASTEM INC
VSTO - VISTA OUTDOOR INC
VTAQ - VENTOUX CCM ACQUISITION CORP
VTEX - VTEX -CLASS A
VTGN - VISTAGEN THERAPEUTICS INC
VTIQ - VECTOIQ ACQUISITION CO-CL A
VTNR - VERTEX ENERGY INC
VTOL - BRISTOW GROUP INC
VTRS - VIATRIS INC
VTRU - VITRU LTD
VTSI - VIRTRA INC
VTVT - VTV THERAPEUTICS INC- CL A
VTYX - VENTYX BIOSCIENCES INC
VUZI - VUZIX CORP
VVI - VIAD CORP
VVNT - VIVINT SMART HOME INC
VVOS - VIVOS THERAPEUTICS INC
VVPR - VIVOPOWER INTERNATIONAL PLC
VVV - VALVOLINE INC
VWE - VINTAGE WINE ESTATES INC
VWTR - VIDLER WATER RESOUCES INC
VXRT - VAXART INC
VYGG - VY GLOBAL GROWTH-CL A
VYGR - VOYAGER THERAPEUTICS INC
VYNE - VYNE THERAPEUTICS INC
VYNT - VYANT BIO INC
VZ - VERIZON COMMUNICATIONS INC
VZIO - VIZIO HOLDING  CORP-A
W - WAYFAIR INC- CLASS A
WAB - WABTEC CORP
WABC - WESTAMERICA BANCORPORATION
WAFD - WASHINGTON FEDERAL INC
WAFU - WAH FU EDUCATION GROUP LTD
WAL - WESTERN ALLIANCE BANCORP
WALD - WALDENCAST ACQUISITION COR-A
WARR - WARRIOR TECHNOLOGIES ACQ-A
WASH - WASHINGTON TRUST BANCORP
WAT - WATERS CORP
WATT - ENERGOUS CORP
WAVC - WAVERLEY CAPITAL ACQUISITI-A
WAVD - WAVEDANCER INC
WBA - WALGREENS BOOTS ALLIANCE INC
WBS - WEBSTER FINANCIAL CORP
WBT - WELBILT INC
WBX - WALLBOX NV
WCC - WESCO INTERNATIONAL INC
WCN - WASTE CONNECTIONS INC
WD - WALKER & DUNLOP INC
WDAY - WORKDAY INC-CLASS A
WDC - WESTERN DIGITAL CORP
WDFC - WD-40 CO
WE - WEWORK INC-CL A
WEAV - WEAVE COMMUNICATIONS INC
WEBR - WEBER INC - CLASS A
WEC - WEC ENERGY GROUP INC
WEJO - WEJO GROUP LTD
WEN - WENDY'S CO/THE
WERN - WERNER ENTERPRISES INC
WETF - WISDOMTREE INVESTMENTS INC
WEX - WEX INC
WEYS - WEYCO GROUP INC
WFC - WELLS FARGO & CO
WFCF - WHERE FOOD COMES FROM INC
WFG - WEST FRASER TIMBER CO LTD
WFRD - WEATHERFORD INTERNATIONAL PL
WGO - WINNEBAGO INDUSTRIES
WH - WYNDHAM HOTELS & RESORTS INC
WHD - CACTUS INC - A
WHF - WHITEHORSE FINANCE INC
WHG - WESTWOOD HOLDINGS GROUP INC
WHLM - WILHELMINA INTERNATIONAL INC
WHR - WHIRLPOOL CORP
WILC - G. WILLI-FOOD INTERNATIONAL
WINA - WINMARK CORP
WING - WINGSTOP INC
WINT - WINDTREE THERAPEUTICS INC
WINV - WINVEST ACQUISITION CORP
WIRE - ENCORE WIRE CORP
WISA - SUMMIT WIRELESS TECHNOLOGIES
WISH - CONTEXTLOGIC INC - A
WIX - WIX.COM LTD
WK - WORKIVA INC
WKHS - WORKHORSE GROUP INC
WKME - WALKME LTD
WKSP - WORKSPORT LTD
WLDN - WILLDAN GROUP INC
WLFC - WILLIS LEASE FINANCE CORP
WLK - WESTLAKE CHEMICAL CORP
WLL - WHITING PETROLEUM CORP
WLTW - WILLIS TOWERS WATSON PLC
WM - WASTE MANAGEMENT INC
WMB - WILLIAMS COS INC
WMG - WARNER MUSIC GROUP CORP-CL A
WMK - WEIS MARKETS INC
WMPN - WILLIAM PENN BANCORP
WMS - ADVANCED DRAINAGE SYSTEMS IN
WMT - WALMART INC
WNC - WABASH NATIONAL CORP
WNEB - WESTERN NEW ENGLAND BANCORP
WNW - MEIWU TECHNOLOGY CO LTD
WOLF - WOLFSPEED INC
WOOF - PETCO HEALTH AND WELLNESS CO
WOR - WORTHINGTON INDUSTRIES
WORX - SCWORX CORP
WOW - WIDEOPENWEST INC
WPCA - WARBURG PINCUS CAPITAL COR-A
WPCB - WARBURG PINCUS CAPITAL I-B
WPM - WHEATON PRECIOUS METALS CORP
WPRT - WESTPORT FUEL SYSTEMS INC
WQGA - WORLD QUANTUM GROWTH ACQUI-A
WRAC - WILLIAMS ROWLAND ACQUISITION
WRAP - WRAP TECHNOLOGIES INC
WRB - WR BERKLEY CORP
WRBY - WARBY PARKER INC-CLASS A
WRK - WESTROCK CO
WRLD - WORLD ACCEPTANCE CORP
WSBC - WESBANCO INC
WSBF - WATERSTONE FINANCIAL INC
WSC - WILLSCOT MOBILE MINI HOLDING
WSFS - WSFS FINANCIAL CORP
WSM - WILLIAMS-SONOMA INC
WSO - WATSCO INC
WSO.B - WATSCO INC  -CL B
WST - WEST PHARMACEUTICAL SERVICES
WSTG - WAYSIDE TECHNOLOGY GROUP INC
WTBA - WEST BANCORPORATION
WTER - ALKALINE WATER CO INC/THE
WTFC - WINTRUST FINANCIAL CORP
WTI - W&T OFFSHORE INC
WTM - WHITE MOUNTAINS INSURANCE GP
WTRG - ESSENTIAL UTILITIES INC
WTRH - WAITR HOLDINGS INC
WTS - WATTS WATER TECHNOLOGIES-A
WTTR - SELECT ENERGY SERVICES INC-A
WU - WESTERN UNION CO
WULF - TERAWULF INC
WVE - WAVE LIFE SCIENCES LTD
WVFC - WVS FINANCIAL CORP
WVVI - WILLAMETTE VALLEY VINEYARDS
WW - WW INTERNATIONAL INC
WWAC - WORLDWIDE WEBB ACQUISITION-A
WWD - WOODWARD INC
WWE - WORLD WRESTLING ENTERTAIN-A
WWW - WOLVERINE WORLD WIDE INC
WYNN - WYNN RESORTS LTD
X - UNITED STATES STEEL CORP
XAIR - BEYOND AIR INC
XBIO - XENETIC BIOSCIENCES INC
XBIT - XBIOTECH INC
XCUR - EXICURE INC
XEL - XCEL ENERGY INC
XELA - EXELA TECHNOLOGIES INC
XELB - XCEL BRANDS INC
XENE - XENON PHARMACEUTICALS INC
XENT - INTERSECT ENT INC
XERS - XERIS BIOPHARMA HOLDINGS INC
XFIN - EXCELFIN ACQUISITION CORP-A
XFOR - X4 PHARMACEUTICALS INC
XGN - EXAGEN INC
XL - XL FLEET CORP
XLNX - XILINX INC
XLO - XILIO THERAPEUTICS INC
XM - QUALTRICS INTERNATIONAL-CL A
XMTR - XOMETRY INC-A
XNCR - XENCOR INC
XOM - EXXON MOBIL CORP
XOMA - XOMA CORP
XOS - XOS INC
XP - XP INC - CLASS A
XPAX - XPAC ACQUISITION CORP-A
XPDI - POWER & DIGITAL INFRAST-CL A
XPEL - XPEL INC
XPER - XPERI HOLDING CORP
XPO - XPO LOGISTICS INC
XPOA - DPCM CAPITAL INC - CLASS A
XPOF - XPONENTIAL FITNESS INC-A
XPRO - EXPRO GROUP HOLDINGS NV
XRAY - DENTSPLY SIRONA INC
XRTX - XORTX THERAPEUTICS INC
XRX - XEROX HOLDINGS CORP
XSPA - XPRESSPA GROUP INC
XXII - 22ND CENTURY GROUP INC
XYL - XYLEM INC
Y - ALLEGHANY CORP
YELL - YELLOW CORP
YELP - YELP INC
YETI - YETI HOLDINGS INC
YEXT - YEXT INC
YGMZ - MINGZHU LOGISTICS HOLDINGS L
YMAB - Y-MABS THERAPEUTICS INC
YMTX - YUMANITY THERAPEUTICS INC
YNDX - YANDEX NV-A
YORW - YORK WATER CO
YOU - CLEAR SECURE INC -CLASS A
YSAC - YELLOWSTONE ACQUISIT CO-CL A
YTEN - YIELD10 BIOSCIENCE INC
YTPG - TPG PACE BENEFICIAL II COR-A
YTRA - YATRA ONLINE INC
YUM - YUM! BRANDS INC
YUMC - YUM CHINA HOLDINGS INC
YVR - LIQUID MEDIA GROUP LTD
Z - ZILLOW GROUP INC - C
ZBH - ZIMMER BIOMET HOLDINGS INC
ZBRA - ZEBRA TECHNOLOGIES CORP-CL A
ZCMD - ZHONGCHAO INC-CLASS A
ZD - ZIFF DAVIS INC
ZEN - ZENDESK INC
ZENV - ZENVIA INC - A
ZEST - ECOARK HOLDINGS INC
ZETA - ZETA GLOBAL HOLDINGS CORP-A
ZEUS - OLYMPIC STEEL INC
ZEV - LIGHTNING EMOTORS INC
ZG - ZILLOW GROUP INC - A
ZGN - ERMENEGILDO ZEGNA HOLDITALIA
ZGNX - ZOGENIX INC
ZI - ZOOMINFO TECHNOLOGIES INC
ZIM - ZIM INTEGRATED SHIPPING SERV
ZION - ZIONS BANCORP NA
ZIOP - ZIOPHARM ONCOLOGY INC
ZIP - ZIPRECRUITER INC-A
ZIVO - ZIVO BIOSCIENCE INC
ZIXI - ZIX CORP
ZKIN - ZK INTERNATIONAL GROUP CO LT
ZM - ZOOM VIDEO COMMUNICATIONS-A
ZNGA - ZYNGA INC - CL A
ZNTE - ZANITE ACQUISITION CORP-CL A
ZNTL - ZENTALIS PHARMACEUTICALS INC
ZS - ZSCALER INC
ZSAN - ZOSANO PHARMA CORP
ZT - ZIMMER ENERGY TRANSITION -A
ZTS - ZOETIS INC
ZUMZ - ZUMIEZ INC
ZUO - ZUORA INC - CLASS A
ZVIA - ZEVIA PBC-A
ZVO - ZOVIO INC
ZWRK - Z-WORK ACQUISITION CORP-A
ZWS - ZURN WATER SOLUTIONS CORP
ZY - ZYMERGEN INC
ZYME - ZYMEWORKS INC
ZYNE - ZYNERBA PHARMACEUTICALS INC
ZYXI - ZYNEX INC
